apt-cache search finger
fprintd - D-Bus daemon for fingerprint reader access
gir1.2-fprint-2.0 - async fingerprint library of fprint project, gir bindings
libdigest-bubblebabble-perl - perl module to create bubble-babble fingerprints
libfprint-2-2 - async fingerprint library of fprint project, shared libraries
libfprint-2-dev - async fingerprint library of fprint project, development headers
libfprint-2-doc - async fingerprint library of fprint project, API documentation
libfprint-2-tod-dev - async fingerprint library of fprint project, drivers development headers
libfprint-2-tod1 - async fingerprint library of fprint project, drivers shared libraries
libpam-fprintd - PAM module for fingerprint authentication through fprintd
arp-scan - arp scanning and fingerprinting tool
cfingerd - configurable finger daemon
createfp - Language detection library - fingerprint generation utility
efingerd - Another finger daemon for unix capable of fine-tuning your output.
finger - user information lookup program
fingerd - remote user information server
fretsonfire-songs-muldjord - game of musical skill and fast fingers - Songs Package
fretsonfire-songs-sectoid - game of musical skill and fast fingers - Songs Package
ike-scan - discover and fingerprint IKE hosts (IPsec VPN Servers)
libchromaprint-dev - audio fingerprinting library - development files
libchromaprint-tools - audio fingerprinting library - tools
libchromaprint1 - audio fingerprint library
libfli-dev - library for Finger Lakes Instrument hardware - development files
libfli2 - library for Finger Lakes Instrument hardware
libghc-fingertree-dev - Generic finger-tree data structure implementation in Haskell
libghc-fingertree-doc - Generic finger-tree data structure implementation in Haskell; documentation
libghc-fingertree-prof - Generic finger-tree data structure implementation in Haskell; profiling libraries
libgroovefingerprinter-dev - acoustid fingerprinter sink for libgroove (development files)
libgroovefingerprinter4 - acoustid fingerprinter for libgroove
liblastfm-fingerprint5-1 - Last.fm fingerprinting library (Qt5 build)
liblastfm-fingerprint5-dbg - Debugging symbols for the fingerprint library (Qt5 build)
libnet-dns-fingerprint-perl - library to determine DNS server vendor, product and version
libnet-finger-perl - perl Module providing an API for Finger queries
libofa0 - library for acoustic fingerprinting
libofa0-dev - library for acoustic fingerprinting (development files)
libwww-finger-perl - get useful data from e-mail addresses
node-webfinger - Client library for Host Meta (RFC 6415) and Webfinger
p0f - Passive OS fingerprinting tool
r-cran-fingerprint - GNU R functions to operate on binary fingerprint data
ruby-ansi - ANSI escape codes at your fingertips
ruby-webfinger - Ruby WebFinger client library
wafw00f - identify and fingerprint Web Application Firewall products
xmms2-plugin-ofa - XMMS2 - Open Fingerprint Architecture plug-in
