apt-cache search gedit
debugedit - tools for handling build-ids and paths rewriting in DWARF data
gedit - official text editor of the GNOME desktop environment
gedit-common - official text editor of the GNOME desktop environment (support files)
gedit-dev - official text editor of the GNOME desktop environment (development files)
biosyntax-gedit - Syntax Highlighting for Computational Biology (gedit)
dgedit - drum kit editor for DrumGizmo
gedit-latex-plugin - gedit plugin for composing and compiling LaTeX documents
gedit-plugin-bookmarks - Bookmarks plugin for gedit
gedit-plugin-bracket-completion - Bracket Completion plugin for gedit
gedit-plugin-character-map - Character Map plugin for gedit
gedit-plugin-code-comment - Code Comment plugin for gedit
gedit-plugin-color-picker - Color Picker plugin for gedit
gedit-plugin-color-schemer - Color Schemer plugin for gedit
gedit-plugin-commander - Commander plugin for gedit
gedit-plugin-draw-spaces - Draw Spaces plugin for gedit
gedit-plugin-find-in-files - Find in Files plugin for gedit
gedit-plugin-git - Git plugin for gedit
gedit-plugin-join-lines - Join/Split Lines plugin for gedit
gedit-plugin-multi-edit - Multi Edit plugin for gedit
gedit-plugin-session-saver - Session Saver plugin for gedit
gedit-plugin-smart-spaces - Smart Spaces plugin for gedit
gedit-plugin-synctex - SyncTex plugin for gedit
gedit-plugin-terminal - Terminal plugin for gedit
gedit-plugin-text-size - Text Size plugin for gedit
gedit-plugin-translate - Translate plugin for gedit
gedit-plugin-word-completion - Word Completion plugin for gedit
gedit-plugins - set of plugins for gedit
gedit-plugins-common - common files for gedit-plugins
gedit-source-code-browser-plugin - source code class and function browser plugin for Gedit
qxgedit - MIDI System Exclusive files editor
rabbitvcs-gedit - Gedit extension for RabbitVCS
supercollider-gedit - SuperCollider mode for Gedit
