apt-cache search git
etckeeper - store /etc in git, mercurial, brz or darcs
git - fast, scalable, distributed revision control system
git-doc - fast, scalable, distributed revision control system (documentation)
git-man - fast, scalable, distributed revision control system (manual pages)
libcdio-cdda2 - library to read and control digital audio CDs
libcdio-paranoia2 - library to read digital audio CDs with error correction
libdv4 - software library for DV format digital video (runtime lib)
libdv4-dev - software library for DV format digital video (devel files)
libdvbv5-0 - Libraries to control, scan and zap on Digital TV channels
libgit-wrapper-perl - Perl module to wrap git command-line interface
libgitlab-api-v4-perl - GitLab API v4 module and command-line client
libgphoto2-6 - gphoto2 digital camera library
libgphoto2-dev - gphoto2 digital camera library (development files)
libgphoto2-dev-doc - gphoto2 digital camera library (development documentation)
libgphoto2-l10n - gphoto2 digital camera library - localized messages
libgphoto2-port12 - gphoto2 digital camera port library
libwebp-dev - Lossy compression of digital photographic images
libwebp7 - Lossy compression of digital photographic images
libwebpdemux2 - Lossy compression of digital photographic images.
libwebpmux3 - Lossy compression of digital photographic images
python-cursive-doc - OpenStack specific validation of digital signatures - doc
python3-cursive - OpenStack specific validation of digital signatures - Python 3
shotwell - digital photo organizer
shotwell-common - digital photo organizer - common files
aevol - digital genetics model to run Evolution Experiments in silico
anacrolix-dms - Go UPnP DLNA Digital Media Server with basic video transcoding
ardour - the digital audio workstation
ardour-data - digital audio workstation (data)
ardour-lv2-plugins - digital audio workstation - lv2 plugins set
ardour-video-timeline - digital audio workstation - video timeline
bat - cat(1) clone with syntax highlighting and git integration
bme280-doc - Python interface for a Bosch BME280 digital sensor module. Docs
bookworm - Simple, focused eBook Reader
brz - easy to use distributed version control system
bup - highly efficient file backup system based on git
bup-doc - highly efficient file backup system based on git (documentation)
bzr-git - transitional dummy package
calypso - CalDAV/CardDAV server with git backend
camera.app - GNUstep application for digital still cameras
cgit - hyperfast web frontend for git repositories written in C
cl-github-v3 - Common Lisp interface to the github V3 API
cmark-gfm - CommonMark parsing and rendering program, GitHub flavor
congruity - graphical utility to configure Logitech Harmony remotes
daisy-player - player for DAISY Digital Talking Books
dbmix - DJ mixer for digital audio streams
dclock - Digital clock for the X Window System with flexible display
dcraw - decode raw digital camera images
dfcgen-gtk - Digital Filter Coefficients Generator (DFCGen) GTK+
dgit - git interoperability with the Debian archive
dgit-infrastructure - dgit server backend infrastructure
digikam - digital photo management application for KDE
digitemp - read temperature sensors in a 1-Wire net
din - digital audio synthesizer
din-data - digital audio synthesizer - data
dleyna-renderer - DBus service to interact with DLNA Digital Media Renderers
dleyna-server - DBus service to interact with DLNA Digital Media Servers
dpkg-source-gitarchive - dpkg source format for git repositories
drc - digital room correction
dsdcc - Digital Speech Decoder (DSD)
dtv-scan-tables - Digital Video Broadcasting (DVB) initial scan files
dvb-apps - Digital Video Broadcasting (DVB) applications
dvgrab - grab digital video data via IEEE1394 and USB links
eancheck - Check digit validator for EAN/PLU/UPC barcode numbers
easygit - git for mere mortals
easyssh - Complete, efficient and easy-to-use SSH manager
electronics-digital - Debian packages for digital design
elpa-eshell-git-prompt - Eshell prompt themes for Git users
elpa-ghub - minuscule client for the Github API
elpa-ghub+ - thick GitHub API client built on ghub
elpa-git-annex - Emacs integration for git-annex
elpa-git-auto-commit-mode - Emacs Minor mode to automatically commit and push with git
elpa-git-commit - Major mode for editing git commit message
elpa-git-messenger - pop up last commit information of current line
elpa-git-modes - major modes for editing Git configuration files
elpa-git-timemachine - walk through git revisions of a file
elpa-gitattributes-mode - major mode for editing Git configuration files (gitattributes)
elpa-gitconfig-mode - major mode for editing Git configuration files (gitconfig and gitmodules)
elpa-gitignore-mode - major mode for editing Git configuration files (gitignore)
elpa-gitlab-ci-mode - Emacs mode for editing GitLab CI files
elpa-magit - Emacs interface for Git
elpa-magit-annex - git-annex subcommands for magit
elpa-magit-forge - Work with Git forges from the comfort of Magit
elpa-magit-popup - Use popup like Magit
elpa-magit-section - Collapsible sections like in Magit
elpa-magit-todos - show source file TODOs in Magit
elpa-treemacs-magit - tree layout file explorer for Emacs
engauge-digitizer - interactively extracts numbers from bitmap graphs or maps
engauge-digitizer-doc - engauge-digitizer user manual and tutorial
exifprobe - read metadata from digital pictures
exiftags - utility to read Exif tags from a digital camera JPEG file
exiftran - digital camera JPEG image transformer
fldigi - digital modem program for hamradio operators
fonts-adf-accanthis - Accanthis font of the Arkandis Digital Foundry
fonts-adf-baskervald - Baskervald font of the Arkandis Digital Foundry
fonts-adf-berenis - Berenis font of the Arkandis Digital Foundry
fonts-adf-gillius - Gillius font of the Arkandis Digital Foundry
fonts-adf-ikarius - Ikarius font of the Arkandis Digital Foundry
fonts-adf-irianis - Irianis font of the Arkandis Digital Foundry
fonts-adf-libris - Libris font of the Arkandis Digital Foundry
fonts-adf-mekanus - Mekanus font of the Arkandis Digital Foundry
fonts-adf-oldania - Oldania font of the Arkandis Digital Foundry
fonts-adf-romande - Romande font of the Arkandis Digital Foundry
fonts-adf-solothurn - Solothurn font of the Arkandis Digital Foundry
fonts-adf-switzera - Switzera font of the Arkandis Digital Foundry
fonts-adf-tribun - Tribun font of the Arkandis Digital Foundry
fonts-adf-universalis - Universalis font of the Arkandis Digital Foundry
fonts-adf-verana - Verana font of the Arkandis Digital Foundry
fonts-octicons - GitHub's icons font
fonts-reggae - display font often used in Japanese boys' magazines and digital content
freedv - Digital Voice mode for ham radio
g15daemon - LCD multiplexer for Logitech G15 Keyboard
g810-led - LED configuration tool for Logitech Gx10 keyboards
gdigi - utility to control DigiTech effect pedals
geany-plugin-git-changebar - git change bar plugin for Geany
geany-plugin-keyrecord - git change bar plugin for Geany
gedit-plugin-git - Git plugin for gedit
gh - GitHub CLI, GitHub??s official command line tool
ghi - GitHub issue tracker command line interface (CLI)
giggle - GTK+ frontend for the git directory tracker
giggle-personal-details-plugin - GTK+ frontend for the git directory tracker - personal details plugin
giggle-terminal-view-plugin - GTK+ frontend for the git directory tracker - terminal plugin
gir1.2-ggit-1.0 - GObject introspection data for the git2-glib-1.0 library
gist - Upload gists to gist.github.com
git-absorb - Git commit --fixup, but automatic
git-all - fast, scalable, distributed revision control system (all subpackages)
git-annex - manage files with git, without checking their contents into git
git-annex-remote-rclone - rclone-based git annex special remote
git-autofixup - Automatically fixup commits with related changes
git-big-picture - Visualization tool for Git repositories
git-build-recipe - construct a Git branch from a recipe
git-buildpackage - Suite to help with Debian packages in Git repositories
git-buildpackage-rpm - Suite to help with RPM packages in Git repositories
git-bump - create Git release commits and tags with changelogs
git-cola - highly caffeinated git GUI
git-crecord - interactively select chunks to commit with Git
git-crypt - Transparent file encryption in git
git-cvs - fast, scalable, distributed revision control system (cvs interoperability)
git-daemon-run - fast, scalable, distributed revision control system (git-daemon service)
git-daemon-sysvinit - fast, scalable, distributed revision control system (git-daemon service)
git-debpush - client script for git pushing to Debian-style archives
git-debrebase - rebasing git workflow tool for Debian packaging
git-dpm - git Debian package manager
git-email - fast, scalable, distributed revision control system (email add-on)
git-evtag - extended verification for git tags
git-evtag-tests - extended verification for git tags - as-installed tests
git-extras - Extra commands for git
git-filter-repo - Quickly rewrite git repository history
git-flow - Git extension to provide a high-level branching model
git-ftp - Git powered FTP client written as shell script
git-gui - fast, scalable, distributed revision control system (GUI)
git-hub - Git command line interface to GitHub
git-imerge - incremental merge and rebase for git
git-lfs - Git Large File Support
git-mediawiki - fast, scalable, distributed revision control system (MediaWiki remote helper)
git-merge-changelog - git merge driver for GNU ChangeLog files
git-phab - Git subcommand to integrate with Phabricator.
git-publish - git command to prepare and store patch revisions as git tags
git-pw - tool for integrating Git with Patchwork
git-quick-stats - simple and efficient way to access various statistics in git repository
git-reintegrate - Git extension to manage integration branches
git-remote-gcrypt - encrypted git repositories
git-remote-hg - bidirectional bridge between Git and Mercurial
git-repair - repair various forms of damage to git repositories
git-restore-mtime - set timestamps to the date of a file's last commit
git-review - git command for submitting branches to Gerrit
git-revise - handy git tool for doing efficient in-memory commit rebases & fixups
git-secret - store encrypted credential inside source code git repository
git-secrets - Prevents accidental commits of credentials
git-sizer - compute various size metrics for a Git repository
git-svn - fast, scalable, distributed revision control system (svn interoperability)
git2cl - Simple tool to convert git logs to GNU ChangeLog format
gita - Manage many git repos
gitbatch - Manage git repositories in one place
gitbrute - brute-force a git commit hash
gitg - git repository viewer
github-backup - backs up data from GitHub
gitinspector - statistical analysis tool for git repositories
gitit - Wiki engine backed by a git or darcs filestore
gitk - fast, scalable, distributed revision control system (revision tree visualizer)
gitlab-cli - GitLab command-line client
gitlab-rulez - tool to help setting up GitLab repository
gitlab-shell - handles git commands for GitLab
gitlabracadabra - Configure GitLab from a YAML file
gitless - version control system on top of Git
gitlint - Git commit message linter
gitmagic - guide about Git version control system
gitolite3 - SSH-based gatekeeper for git repositories (version 3)
gitpkg - tools for maintaining Debian packages with git
gitso - simple frontend for reverse VNC connections (remote assistance)
gitsome - Supercharged Git/Shell Autocompleter with GitHub Integration
gitweb - fast, scalable, distributed revision control system (web interface)
gmt-dcw - Digital Chart of the World (DCW) for GMT
go-git - highly extensible Git implementation in pure Go (command line)
golang-clockwork-dev - Transitional package for golang-github-jonboulle-clockwork-dev
golang-code.gitea-git-dev - Go module that provides git access through shell
golang-code.gitea-sdk-dev - SDK implementation to interact with the Gitea API
golang-codegangsta-cli-dev - Transitional package for golang-github-codegangsta-cli-dev
golang-context-dev - Transitional package for golang-github-gorilla-context-dev
golang-dbus-dev - Go client bindings for D-Bus
golang-docker-dev - Transitional package for golang-github-docker-docker-dev
golang-etcd-server-dev - highly-available key value store -- source
golang-ginkgo-dev - Transitional package for golang-github-onsi-ginkgo-dev
golang-gitaly-proto-dev - Protobuf specifications and client libraries for Gitaly
golang-github-0xax-notificator-dev - Desktop notifications with golang
golang-github-14rcole-gopopulate-dev - Small library to populate a directory with random data
golang-github-a8m-tree-dev - implementation of the tree command
golang-github-aalpar-deheap-dev - Doubly ended heap implementation (library)
golang-github-abbot-go-http-auth-dev - Basic and Digest HTTP Authentication for golang http
golang-github-abdullin-seq-dev - structural equality library
golang-github-abeconnelly-autoio-dev - functions that provide standard scanner interfaces for compressed files
golang-github-acarl005-stripansi-dev - Little Go package for removing ANSI color escape codes from strings
golang-github-adam-hanna-arrayoperations-dev - Small library for performing operations on slices in golang
golang-github-adam-lavrik-go-imath-dev - elementary functions for integer arguments (library)
golang-github-adrg-xdg-dev - implementation of the XDG Base Directory Specification and XDG user directories
golang-github-adrianmo-go-nmea-dev - Go library for the NMEA 0183 protocol
golang-github-advancedlogic-goose-dev - Html Content / Article Extractor in Golang (library)
golang-github-aead-chacha20-dev - ChaCha20 and XChaCha20 stream ciphers go library
golang-github-aead-poly1305-dev - poly1305 message authentication code go library
golang-github-aelsabbahy-gonetstat-dev - Netstat implementation in Go
golang-github-agext-levenshtein-dev - Levenshtein distance and similarity metrics
golang-github-agtorre-gocolorize-dev - Stateful ANSI coloring for Go
golang-github-ajg-form-dev - Form Encoding & Decoding Package for Go
golang-github-ajstarks-svgo-dev - generating online histograms and plotting them with golang
golang-github-akamai-akamaiopen-edgegrid-golang-dev - Authentication handler for the Akamai OPEN EdgeGrid Authentication scheme
golang-github-akavel-rsrc-dev - Go library for embedding binary resources in executables
golang-github-akrennmair-gopcap-dev - simple wrapper around libpcap for Golang
golang-github-alangpierce-go-forceexport-dev - access unexported functions from other packages
golang-github-albenik-go-serial-dev - Cross-platform serial library for go-lang (library)
golang-github-alcortesm-tgz-dev - Go library to extract tgz files to temporal directories
golang-github-alecaivazis-survey-dev - golang library for building interactive prompts
golang-github-alecthomas-assert-dev - Fork of stretchr/testify/assert that uses FailNow()
golang-github-alecthomas-binary-dev - general purpose binary encoder/decoder
golang-github-alecthomas-chroma-dev - general purpose syntax highlighter in pure Go (libraries)
golang-github-alecthomas-colour-dev - Quake-style colour formatting for Unix terminals
golang-github-alecthomas-jsonschema-dev - Generate JSON Schemas from Go types (library)
golang-github-alecthomas-kong-dev - command-line parser for Go
golang-github-alecthomas-kong-hcl-dev - Kong configuration loader for HCL (Go library)
golang-github-alecthomas-participle-dev - parser library for Go (library)
golang-github-alecthomas-repr-dev - Python's repr() for Go
golang-github-alecthomas-units-dev - Go package for parsing byte units
golang-github-aleksi-pointer-dev - helpers to get pointers to values of built-in types
golang-github-alessio-shellescape-dev - Escape arbitrary strings for use as command line arguments
golang-github-alexcesaro-log-dev - Logging packages for Go (library)
golang-github-alexflint-go-arg-dev - Struct-based argument parsing in Go
golang-github-alexflint-go-filemutex-dev - processes synchronization library
golang-github-alexflint-go-scalar-dev - scalar parsing library in Golang
golang-github-alicebob-miniredis-dev - Pure Go Redis server for Go unittests
golang-github-aliyun-aliyun-oss-go-sdk-dev - Alibaba Cloud OSS SDK for Go
golang-github-allegro-bigcache-dev - efficient cache for gigabytes of data written in Go (library)
golang-github-anacrolix-dms-dev - Go source for UPnP DLNA Digital Media Server
golang-github-anacrolix-envpprof-dev - configures Go's pprof and default HTTP mux
golang-github-anacrolix-ffprobe-dev - Go ffprobe wrapper
golang-github-anacrolix-missinggo-bin-static - Stuff that's missing in Go stdlib, or hasn't made it into its own repo.
golang-github-anacrolix-missinggo-dev - Stuff that's missing in Go stdlib, or hasn't made it into its own repo.
golang-github-anacrolix-tagflag-dev - declarative flag parsing for Go using struct tags
golang-github-andreykaipov-goobs-dev - control OBS Studio via WebSockets (Go library)
golang-github-andreyvit-diff-dev - quick'n'easy string diffs for Golang
golang-github-andybalholm-brotli-dev - pure Go Brotli encoder and decoder (library)
golang-github-andybalholm-cascadia-dev - CSS selector library in Go
golang-github-andybalholm-crlf-dev - handling CR/LF line endings for Go language
golang-github-anmitsu-go-shlex-dev - Library to make a lexical analyzer like Unix shell for golang
golang-github-ant0ine-go-json-rest-dev - quick and easy way to setup a RESTful JSON API (library)
golang-github-antchfx-jsonquery-dev - Golang XPath query for JSON query
golang-github-antchfx-xmlquery-dev - Go XPath package for XML query
golang-github-antchfx-xpath-dev - XPath package for Golang, supported HTML, XML, JSON query
golang-github-antlr-antlr4-dev - runtime library for ANTLR 4
golang-github-antonmedv-expr-dev - expression evaluation engine for Go
golang-github-apex-log-dev - structured logging package for Go
golang-github-apparentlymart-go-cidr-dev - manipulations of CIDR netmasks and their associated addresses
golang-github-apparentlymart-go-dump-dev - utility for formatting Go values in a pretty-printed way
golang-github-apparentlymart-go-openvpn-mgmt-dev - Go client library for OpenVPN's management protocol
golang-github-apparentlymart-go-rundeck-api-dev - Go client for the Rundeck HTTP API
golang-github-apparentlymart-go-shquot-dev - helper functions for quoting and escaping strings
golang-github-apparentlymart-go-textseg-dev - Golang implementation of Unicode Text Segmentation
golang-github-apparentlymart-go-userdirs-dev - finding user-specific application data directories
golang-github-apparentlymart-go-versions-dev - version-wrangling library for Go
golang-github-appc-cni-dev - container network interface
golang-github-appc-docker2aci-dev - library to convert Docker images to ACIs
golang-github-appc-goaci-dev - build go projects into ACIs
golang-github-appc-spec-dev - App Container Specification (appc) - source
golang-github-appleboy-gin-jwt-dev - JWT middleware for the Gin framework
golang-github-appleboy-gofight-dev - API Handler Testing for Golang Web framework
golang-github-approvals-go-approval-tests-dev - ApprovalTests for go
golang-github-aquasecurity-go-dep-parser-dev - dependency parser for multiple programming languages in go
golang-github-aquasecurity-go-version-dev - Go library for parsing and verifying versions and version constraints
golang-github-araddon-dateparse-dev - Go library used to parse date from string
golang-github-araddon-gou-dev - logging and json helpers for Go
golang-github-arceliar-ironwood-dev - Routing library with public keys as addresses (library)
golang-github-arceliar-phony-dev - Ponylang-inspired actor model library for Go (library)
golang-github-armon-circbuf-dev - Golang circular (ring) buffer
golang-github-armon-consul-api-dev - [DEPRECATED] Golang API client for Consul
golang-github-armon-go-metrics-dev - library for exporting performance and runtime metrics
golang-github-armon-go-proxyproto-dev - Golang package to handle HAProxy Proxy Protocol
golang-github-armon-go-radix-dev - Golang implementation of Radix trees
golang-github-armon-go-socks5-dev - SOCKS5 server in Golang
golang-github-aryann-difflib-dev - Simple go library for diffing two sequences of text
golang-github-asaskevich-govalidator-dev - Validators and sanitizers for strings, numerics, slices and structs
golang-github-atotto-clipboard-dev - Clipboard for Go
golang-github-audriusbutkevicius-go-nat-pmp-dev - Go language client for the NAT-PMP internet
golang-github-audriusbutkevicius-kcp-go-dev - full-featured reliable UDP communication library
golang-github-audriusbutkevicius-pfilter-dev - filtering packets into multiple virtual connections
golang-github-audriusbutkevicius-recli-dev - Reflection based CLI generator for Golang (library)
golang-github-avast-apkparser-dev - APK manifest & resources parsing in Golang.
golang-github-avast-apkverifier-dev - Android APK Signature verification Go library
golang-github-avast-retry-go-dev - retry mechanism library for Go
golang-github-aviau-gopass-dev - pass implementation in Go - dev package
golang-github-awalterschulze-gographviz-dev - Graphviz DOT language in golang
golang-github-aws-aws-sdk-go-dev - AWS SDK for the Go programming language
golang-github-axgle-mahonia-dev - Character-set conversion library implemented in Go. (library)
golang-github-aymerick-douceur-dev - simple CSS parser and inliner in Go (library)
golang-github-azure-azure-pipeline-go-dev - HTTP request/response middleware pipeline
golang-github-azure-azure-sdk-for-go-dev - Microsoft Azure SDK for Go
golang-github-azure-azure-storage-blob-go-dev - Microsoft Azure Blob Storage Library for Go
golang-github-azure-go-ansiterm-dev - Go package for ANSI terminal emulation in Windows
golang-github-azure-go-autorest-dev - HTTP request pipeline suitable for use across multiple go-routines
golang-github-azure-go-ntlmssp-dev - NTLM/Negotiate authentication over HTTP (Go library)
golang-github-azure-go-pkcs12-dev - PCKS#12 implementation for Go
golang-github-badgerodon-collections-dev - Collection of Golang types
golang-github-beevik-etree-dev - parse and generate XML easily in go
golang-github-beevik-ntp-dev - simple NTP client for Go (library)
golang-github-benbjohnson-clock-dev - library for mocking time in Go
golang-github-benbjohnson-immutable-dev - Immutable collections for Go (library)
golang-github-benbjohnson-tmpl-dev - Command line interface to Go's text/template library - dev package
golang-github-beorn7-perks-dev - effective computation of things
golang-github-bep-debounce-dev - Debouncer written in Go
golang-github-bep-gitmap-dev - map all filenames to info objects for a given git revision
golang-github-bep-go-tocss-dev - simple-to-use LibSass Go API
golang-github-bep-godartsass-dev - Go API backed by the native Dart Sass Embedded executable
golang-github-bep-golibsass-dev - Easy-to-use Go bindings for LibSass
golang-github-bep-gowebp-dev - C bindings and an API for encoding WebP images (Go library)
golang-github-bep-inflect-dev - inflection rules for the English language
golang-github-bep-tmc-dev - provides round-trip serialization of typed Go maps
golang-github-bettercap-nrf24-dev - allows interaction with nRF24LU1+ based USB dongles (library)
golang-github-bettercap-readline-dev - Readline is a pure go implementation for a GNU-Readline like library
golang-github-bgentry-go-netrc-dev - Golang package for reading and writing netrc files
golang-github-bgentry-speakeasy-dev - Golang helpers for reading password input without cgo
golang-github-bgp-stayrtr-dev - Cloudflare's RPKI to router library
golang-github-bifurcation-mint-dev - Minimal TLS 1.3 Implementation in Go.
golang-github-biogo-biogo-dev - biogo is a bioinformatics library for Go (library)
golang-github-biogo-graph-dev - b?ogo undirected graph analysis repository (library)
golang-github-biogo-hts-dev - biogo high throughput sequencing repository
golang-github-biogo-store-dev - b?ogo data store repository (library)
golang-github-bitly-go-simplejson-dev - Golang library to interact with arbitrary JSON
golang-github-bits-and-blooms-bitset-dev - implementation of bitsets
golang-github-bkaradzic-go-lz4-dev - port of the LZ4 lossless compression algorithm to Go
golang-github-blang-semver-dev - semantic versioning library
golang-github-blevesearch-bleve-dev - modern text indexing library for go
golang-github-blevesearch-go-porterstemmer-dev - Native Go implementation of the Porter Stemming algorithm
golang-github-blevesearch-segment-dev - Go library for performing Unicode Text Segmentation
golang-github-bluebreezecf-opentsdb-goclient-dev - Go client for OpenTSDB REST API
golang-github-bmatcuk-doublestar-dev - support for double star matches in golang's path.Match and filepath.Glob
golang-github-bmatsuo-lmdb-go-dev - Bindings for the LMDB C library
golang-github-bmizerany-assert-dev - Assertions library for Go tests
golang-github-bmizerany-pat-dev - Sinatra style pattern muxer for Go's net/http library
golang-github-bndr-gotabulate-dev - Gotabulate - Easily pretty-print your tabular data with Go (library)
golang-github-boj-redistore-dev - session store backend for gorilla/sessions using Redis
golang-github-boltdb-bolt-dev - low-level key/value database for Go
golang-github-bowery-prompt-dev - Cross platform prompting library for Go
golang-github-bradfitz-gomemcache-dev - Go memcached client library
golang-github-bradfitz-iter-dev - Range over integers [0,n). Seriously, that's it.
golang-github-bradleyjkemp-cupaloy-dev - simple Go snapshot testing
golang-github-brentp-bix-dev - Tabix file access with golang using biogo machinery (library)
golang-github-brentp-goluaez-dev - Easy embedding Lua in go
golang-github-brentp-gsort-dev - library package for gsort
golang-github-brentp-irelate-dev - Streaming relation testing of sorted files of intervals
golang-github-brentp-vcfgo-dev - Golang library to read, write, manipulate VCF format files
golang-github-briandowns-spinner-dev - Go library for providing a terminal spinner/progress indicator with options
golang-github-bruth-assert-dev - Simple test assertions for Golang tests
golang-github-bshuster-repo-logrus-logstash-hook-dev - Logstash hook for Logrus logging library for Go
golang-github-bsipos-thist-dev - generating online histograms and plotting them with golang
golang-github-bsm-pool-dev - simple connection pool library for Golang
golang-github-bsm-redeo-dev - Framework for building redis-compatible TCP services
golang-github-bsphere-le-go-dev - Golang library for logentries.com
golang-github-btcsuite-btcd-btcec-dev - Go library for Elliptic curve cryptography
golang-github-btcsuite-btcd-chaincfg-chainhash-dev - generic hash types and functions for Go
golang-github-btcsuite-fastsha256-dev - Go alternative fast SHA256 implementation
golang-github-buger-goterm-dev - advanced terminal output in Golang
golang-github-buger-jsonparser-dev - fast schemaless JSON parser for Go
golang-github-bugsnag-bugsnag-go-dev - automatic panic monitoring for Go applications
golang-github-bugsnag-panicwrap-dev - Go library for catching and handling panics in Go applications
golang-github-burntsushi-locker-dev - simple Go package for conveniently using named read/write locks
golang-github-burntsushi-toml-dev - TOML parser and encoder for Go with reflection
golang-github-burntsushi-xgb-dev - Low-level API to communicate with the X server. See the reference
golang-github-c-bata-go-prompt-dev - building powerful interactive prompts in Go
golang-github-caarlos0-env-dev - Go library for parse environment variables to structs
golang-github-cactus-go-statsd-client-dev - statsd client for Go
golang-github-caddyserver-certmagic-dev - Go library for automatic HTTPS using Let's Encrypt
golang-github-calmh-du-dev - Get disk usage information like how much space is available, free, and used
golang-github-calmh-luhn-dev - Luhn-mod-N implementation in Go
golang-github-calmh-randomart-dev - generates OpenSSH-style randomart (Go library)
golang-github-calmh-xdr-dev - Go XDR enc/decoder - dev package
golang-github-canonical-go-dqlite-dev - Go bindings for libdqlite
golang-github-ccding-go-stun-dev - implementation of the STUN client (RFC 3489 and RFC 5389)
golang-github-cenk-hub-dev - Simple PubSub (Publish/Subscribe) library in Go
golang-github-cenk-rpc2-dev - bi-directional RPC in Go
golang-github-cenkalti-backoff-dev - exponential backoff algorithm in Go
golang-github-census-instrumentation-opencensus-proto-dev - language independent interface types for opencensus
golang-github-centrifugal-centrifuge-dev - real-time messaging library with scalability in mind
golang-github-centrifugal-protocol-dev - Centrifuge client-server protocol definitions
golang-github-centurylinkcloud-clc-sdk-dev - SDK for Century Link Cloud
golang-github-cespare-xxhash-dev - implementation of the 64-bit xxHash algorithm (XXH64)
golang-github-chai2010-gettext-go-dev - GNU gettext for Go (library)
golang-github-charmbracelet-bubbles-dev - TUI components for Bubble Tea ?? (Go library)
golang-github-charmbracelet-bubbletea-dev - powerful little TUI framework for Go ??
golang-github-charmbracelet-glamour-dev - stylesheet-based markdown rendering for your CLI apps (Go library)
golang-github-charmbracelet-harmonica-dev - simple, efficient spring animation library for Go ??
golang-github-charmbracelet-keygen-dev - SSH key pair generator (Go library)
golang-github-charmbracelet-lipgloss-dev - style definitions for nice terminal layouts ?? (Go library)
golang-github-charmbracelet-wish-dev - Make SSH apps, just like that! ?? (Go library)
golang-github-checkpoint-restore-go-criu-dev - CRIU bindings for Golang
golang-github-cheekybits-genny-dev - Elegant generics for Go
golang-github-cheekybits-is-dev - Mini testing helper for Go
golang-github-cheggaaa-pb.v3-dev - simple console progress bar for Go
golang-github-chifflier-nfqueue-go-dev - Go bindings for NFQueue
golang-github-chmduquesne-rollinghash-dev - Implementation of some rolling checksums in golang
golang-github-christrenkamp-goxpath-dev - XPath 1.0 implementation written in Go
golang-github-chromedp-sysutil-dev - cross platform system utilities
golang-github-chzyer-readline-dev - Readline is a pure go implementation for a GNU-Readline like library
golang-github-cilium-ebpf-dev - eBPF Library for Go
golang-github-circonus-labs-circonus-gometrics-dev - Golang implementation of metrics reporting for Cirocnus
golang-github-circonus-labs-circonusllhist-dev - implementation of Circonus log-linear histograms
golang-github-clbanning-mxj-dev - mxj - to/from maps, XML and JSON (Go library)
golang-github-cli-browser-dev - helpers to open URLs, files, or readers in a web browser (Go library)
golang-github-cli-oauth-dev - perform OAuth Device flow and Web application flow (Go library)
golang-github-cli-safeexec-dev - safer version of exec.LookPath on Windows
golang-github-cli-shurcool-graphql-dev - GraphQL client implementation for Go (GitHub CLI fork)
golang-github-client9-reopen-dev - freopen functionality for golang's io.Writers (library)
golang-github-cloudflare-cfssl-dev - CloudFlare's PKI and TLS toolkit
golang-github-cloudflare-circl-dev - Cloudflare Interoperable Reusable Cryptographic Library (golang)
golang-github-cloudflare-go-metrics-dev - Cloudflare's fork of Go port of Coda Hale's Metrics library
golang-github-cloudflare-gokey-dev - simple vaultless password manager in Go - dev package
golang-github-cloudflare-gortr-dev - Cloudflare's RPKI to router library
golang-github-cloudflare-redoctober-dev - Software-based two-man rule style (development files)
golang-github-cloudflare-sidh-dev - Supersingular Isogeny Diffie-Hellman golang library
golang-github-cloudflare-tableflip-dev - Graceful process restarts in Go (library)
golang-github-cloudfoundry-gosigar-dev - golang implementation of the sigar API
golang-github-cloudfoundry-jibber-jabber-dev - Cross Platform locale detection for Golang
golang-github-clusterhq-flocker-go-dev - Flocker go library
golang-github-cnf-structhash-dev - get hash strings of arbitrary data structures
golang-github-cockroachdb-apd-dev - arbitrary-precision decimals for Go
golang-github-cockroachdb-cmux-dev - Payload-based connection multiplexer for Golang
golang-github-cockroachdb-cockroach-go-dev - Packages for go clients.
golang-github-codahale-hdrhistogram-dev - implementation of Gil Tene's HDR Histogram
golang-github-codegangsta-cli-dev - simple library for building command line apps in Go
golang-github-codegangsta-negroni-dev - idiomatic HTTP middleware for Golang
golang-github-confluentinc-confluent-kafka-go-dev - Apache Kafka Golang client by Confluent
golang-github-containerd-btrfs-dev - Btrfs bindings for Go
golang-github-containerd-cgroups-dev - cgroups package for Go
golang-github-containerd-console-dev - Console package for Go
golang-github-containerd-containerd-dev - runC develpoment files
golang-github-containerd-continuity-dev - Externally reusable Go packages included with Continuity
golang-github-containerd-fifo-dev - fifo pkg for Go
golang-github-containerd-go-cni-dev - generic CNI library to provide APIs for CNI plugin interactions
golang-github-containerd-go-runc-dev - runc bindings for Go
golang-github-containerd-ttrpc-dev - GRPC for low-memory environments
golang-github-containerd-typeurl-dev - Go package for managing marshaled types to protobuf.Any
golang-github-containernetworking-plugin-dnsname - name resolution for containers
golang-github-containernetworking-plugins-dev - standard networking plugins - sources
golang-github-containers-buildah-dev - tool to facilitate building OCI images
golang-github-containers-common - Common files for github.com/containers repositories
golang-github-containers-common-dev - Common files for github.com/containers repositories (library)
golang-github-containers-image - Configuration files and manpages for github.com/containers repositories
golang-github-containers-image-dev - golang library to work with containers' images
golang-github-containers-ocicrypt-dev - Encryption libraries for Encrypted OCI Container images (library)
golang-github-containers-psgo-dev - ps(1) AIX-format compatible Golang library
golang-github-containers-storage-dev - Go library for handling how containers are stored on disk
golang-github-coreos-bbolt-dev - low-level key/value database for Go, especially CoreOS's etcd
golang-github-coreos-gexpect-dev - library for starting and controlling subprocesses
golang-github-coreos-go-iptables-dev - Go bindings for iptables utility
golang-github-coreos-go-json-dev - Go's encoding/json library plus Node struct support (library)
golang-github-coreos-go-oidc-dev - Go libraries for implementing OIDC clients and servers
golang-github-coreos-go-semver-dev - Go library for semantic versioning
golang-github-coreos-go-systemd-dev - Go client bindings for systemd socket activation, journal and D-Bus
golang-github-coreos-go-tspi-dev - TSPI bindings for Golang
golang-github-coreos-ioprogress-dev - progress bars around io.Reader/Writers
golang-github-coreos-pkg-dev - collection of Go utility packages
golang-github-coreos-vcontext-dev - Library for validating json and yaml configs in Go (library)
golang-github-corpix-uarand-dev - random user-agent generator
golang-github-cosiner-argv-dev - Argv allows splitting a command line string into an arguments slice
golang-github-couchbase-ghistogram-dev - simple int histogram for golang
golang-github-couchbase-moss-dev - moss provides a fast key/value storage library for golang
golang-github-cpuguy83-go-md2man-v2-dev - utility to create manpages from markdown (source)
golang-github-creack-goselect-dev - select(2) implementation in Go (library)
golang-github-creack-pty-dev - PTY interface for Golang
golang-github-creekorful-mvnparser-dev - Go parser for maven (POM) file
golang-github-crewjam-httperr-dev - golang error object that speaks HTTP
golang-github-crewjam-saml-dev - SAML library for Golang
golang-github-crossdock-crossdock-go-dev - Go client for Crossdock
golang-github-cryptix-wav-dev - Golang .wav reader and writer (development file)
golang-github-ctdk-chefcrypto-dev - Go cryptographic routines to interact with chef servers
golang-github-ctdk-go-trie-dev - Trie implementation based on a minimal automaton for Go
golang-github-ctdk-goiardi-dev - Golang library to interact with a chef server
golang-github-cupcake-rdb-dev - Redis RDB parser for Go
golang-github-cyberdelia-go-metrics-graphite-dev - Graphite client for the go-metrics
golang-github-cyberdelia-heroku-go-dev - Heroku Platform API Go Client
golang-github-cyphar-filepath-securejoin-dev - filepath.SecureJoin implementation
golang-github-cznic-b-dev - B+tree implementation
golang-github-cznic-bufs-dev - simple buffer cache
golang-github-cznic-fileutil-dev - Golang file utility functions
golang-github-cznic-lldb-dev - low level database engine
golang-github-cznic-mathutil-dev - extensions to the Golang "rand" and "math" packages
golang-github-cznic-ql-dev - pure Go embedded SQL database
golang-github-cznic-sortutil-dev - extensions to standard Go "sort" package
golang-github-cznic-strutil-dev - extensions to standard Go "strings" package
golang-github-cznic-zappy-dev - zappy block-based compression format
golang-github-d2g-dhcp4-dev - DHCP packet creation library for Go
golang-github-d2g-dhcp4client-dev - DHCP client written in Go
golang-github-d2r2-go-bsbmp-dev - interact with Bosch Sensortec BMP180/BMP280/BME280/BMP388 sensors (library)
golang-github-d2r2-go-i2c-dev - I2C-bus interaction of peripheral sensors with single-board computers (library)
golang-github-d2r2-go-logger-dev - Go logger functionality with package-level logging separation (library)
golang-github-d2r2-go-sht3x-dev - interact with Sensirion SHT3x humidity and temperature sensor family (library)
golang-github-d4l3k-messagediff-dev - library for doing diffs of arbitrary Golang structs
golang-github-daaku-go.zipexe-dev - zipexe attempts to open an executable binary file as a zip file
golang-github-danverbraganza-varcaser-dev - Go lib to transform between common variable casing conventions
golang-github-danwakefield-fnmatch-dev - Updated clone of kballard??s fnmatch(3) implementation for Go
golang-github-data-dog-go-sqlmock-dev - Sql mock driver for golang to test database interactions
golang-github-datadog-datadog-go-dev - Go client library for datadog
golang-github-datadog-zstd-dev - Zstd wrapper for Go
golang-github-dataence-porter2-dev - native Go high-performance Porter2 stemmer for English
golang-github-dave-jennifer-dev - code generator for Go (library)
golang-github-davecgh-go-spew-dev - Implements a deep pretty printer for Go data structures to aid in debugging
golang-github-davecgh-go-xdr-dev - Pure Go XDR standard (RFC 4506) implementation
golang-github-daviddengcn-go-colortext-dev - change the color of console text in Go
golang-github-dchest-blake2b-dev - Go implementation of BLAKE2 (b) cryptographic hash function
golang-github-dchest-cssmin-dev - Go package to minify CSS
golang-github-dchest-safefile-dev - Implements safe "atomic" saving of files for Go
golang-github-dchest-uniuri-dev - generator of random strings to identify unique objects
golang-github-dcso-bloom-cli - highly efficient bloom filter implementation for Go, CLI tool
golang-github-dcso-bloom-dev - highly efficient bloom filter implementation for Go
golang-github-dcso-fluxline-dev - Golang library to prepare sets of metrics in InfluxDB's Line Protocol format
golang-github-ddevault-go-libvterm-dev - aerc fork of go-libvterm (library)
golang-github-deanthompson-ginpprof-dev - wrapper for golang web framework gin to use net/http/pprof
golang-github-deckarep-golang-set-dev - simple set type for the Go language
golang-github-denisenkom-go-mssqldb-dev - Microsoft SQL server driver written in go language
golang-github-dennwc-varint-dev - fast varint library for Go (library)
golang-github-denverdino-aliyungo-dev - Go SDK for Aliyun (Alibaba Cloud)
golang-github-derekparker-trie-dev - Data structure and algorithms for prefix/fuzzy string searching
golang-github-dghubble-sling-dev - HTTP client library for creating and sending API requests
golang-github-dgraph-io-badger-dev - Fast key-value DB in Go - development files for embedding.
golang-github-dgraph-io-ristretto-dev - high performance memory-bound Go cache
golang-github-dgrijalva-jwt-go-dev - Golang implementation of JSON Web Tokens (JWT)
golang-github-dgryski-go-bits-dev - amd64 optimized bit operations
golang-github-dgryski-go-bitstream-dev - read and write bits from io.Reader and io.Writer
golang-github-dgryski-go-farm-dev - pure-Go FarmHash implementation
golang-github-dgryski-go-metro-dev - metrohash library in golang
golang-github-dgryski-go-minhash-dev - BottomK minwise hashing for streaming set similarity
golang-github-dgryski-go-sip13-dev - library for siphash 1-3
golang-github-dhowett-go-plist-dev - pure Go Apple Property List transcoder
golang-github-digitalocean-go-libvirt-dev - Pure Go interface for interacting with libvirt (library)
golang-github-digitalocean-go-qemu-dev - Go packages to interact with QEMU using the QEMU Machine Protocol
golang-github-digitalocean-go-smbios-dev - Detection and access to SMBIOS and DMI data and structures (library)
golang-github-digitalocean-godo-dev - DigitalOcean API V2 client library for Google Go
golang-github-dimchansky-utfbom-dev - Detection of the BOM and removing as necessary
golang-github-disintegration-gift-dev - Go Image Filtering Toolkit
golang-github-disintegration-imaging-dev - Simple Go image processing package
golang-github-disiqueira-gotree-dev - Tree printer module written in GoLang (library)
golang-github-disposaboy-jsonconfigreader-dev - proxy for golang's io.Reader allowing you to use json as a config format
golang-github-djherbis-atime-dev - file access times (atime) for #golang
golang-github-djherbis-times-dev - file times (atime, mtime, ctime, btime)
golang-github-dkolbly-wl-dev - Golang wayland protocol implementation. (library)
golang-github-dlclark-regexp2-dev - Regex engine for Go based on the .NET engine
golang-github-dnaeon-go-vcr-dev - Record and replay your HTTP interactions for tests
golang-github-dnstap-golang-dnstap-cli - dnstap command line tool
golang-github-dnstap-golang-dnstap-dev - flexible, structured event replication format for DNS servers
golang-github-docker-distribution-dev - Docker toolset to pack, ship, store, and deliver content (source)
golang-github-docker-docker-credential-helpers-dev - native stores to safeguard Docker credentials - library
golang-github-docker-docker-dev - Externally reusable Go packages included with Docker
golang-github-docker-go-connections-dev - Golang utility package to work with network connections
golang-github-docker-go-dev - Go packages with small patches autogenerated (used for canonical/json)
golang-github-docker-go-events-dev - Composable event distribution for Go
golang-github-docker-go-metrics-dev - Package for metrics collection in Docker projects
golang-github-docker-go-units-dev - parse and print size and time units in human-readable format
golang-github-docker-leadership-dev - distributed leader election using docker/libkv
golang-github-docker-libkv-dev - Key/Value store abstraction library
golang-github-docker-libtrust-dev - Primitives for identity and authorization
golang-github-docker-notary-dev - library for running and interacting with trusted collections
golang-github-docker-spdystream-dev - multiplexed stream library using spdy
golang-github-docopt-docopt-go-dev - Implementation of docopt in the Go programming language
golang-github-donovanhide-eventsource-dev - Server Side Events client and server for Go (library)
golang-github-dop251-goja-dev - ECMAScript 5.1(+) implementation written in Go
golang-github-dpotapov-go-spnego-dev - Golang library to make HTTP calls with Kerberos authentication
golang-github-dreamitgetit-statuscake-dev - Go client for statuscake.com
golang-github-dropbox-dropbox-sdk-go-unofficial-dev - Unofficial Go SDK for integrating with the Dropbox API v2
golang-github-dsnet-golib-dev - Collection of mostly unrelated helper Go packages
golang-github-dtylman-scp-dev - A simple go scp client (library)
golang-github-duo-labs-webauthn-dev - WebAuthn (FIDO2) server library
golang-github-dustin-go-humanize-dev - format units to human friendly sizes
golang-github-dustinkirkland-golang-petname-dev - golang library for generating pronouncable, memorable, pet names
golang-github-dvsekhvalnov-jose2go-dev - Go implementation of Javascript Object Signing and Encryption
golang-github-dylanmei-iso8601-dev - pure Go ISO8601 parser and formatter
golang-github-dylanmei-winrmtest-dev - testing addon for golang-github-masterzen-winrm
golang-github-eapache-go-xerial-snappy-dev - Xerial-compatible Snappy framing support for Go
golang-github-eclipse-paho.mqtt.golang-dev - Go package implementing MQTT client library by Eclipse Paho
golang-github-edsrzf-mmap-go-dev - portable mmap package for Go
golang-github-eknkc-amber-dev - Elegant HTML templating engine for Go, inspired from HAML and Jade (Go library)
golang-github-ekzhu-minhash-lsh-dev - Minhash LSH in Golang
golang-github-elazarl-go-bindata-assetfs-dev - Go library to serve embedded binary files with net/http
golang-github-elazarl-goproxy-dev - HTTP proxy library for Go
golang-github-elisescu-pty-dev - Golang package for using Unix pseudo-terminals
golang-github-elithrar-simple-scrypt-dev - various purpose password hashes library using the scrypt KDF
golang-github-ema-qdisc-dev - get queuing discipline information via netlink (library)
golang-github-emersion-go-imap-dev - Go IMAP library for clients and servers
golang-github-emersion-go-imap-idle-dev - IDLE extension for go-imap (library)
golang-github-emersion-go-imap-sortthread-dev - SORT and THREAD extensions for go-imap (library)
golang-github-emersion-go-maildir-dev - Maildir library for Go (library)
golang-github-emersion-go-message-dev - Streaming Go library for the Internet Message Format and mail
golang-github-emersion-go-pgpmail-dev - PGP-encrypted email library for Go (library)
golang-github-emersion-go-sasl-dev - SASL library written in Go
golang-github-emersion-go-smtp-dev - ESMTP client & server library written in Go (library)
golang-github-emersion-go-textwrapper-dev - Go writer that wraps long text lines to a specified length
golang-github-emicklei-go-restful-dev - build REST-style Web Services using Google Go
golang-github-emicklei-go-restful-swagger12-dev - Swagger 1.2 extension to the go-restful package
golang-github-emirpasic-gods-dev - Implementation of various data structures and algorithms in Go
golang-github-enescakir-emoji-dev - minimalistic emoji package for Go
golang-github-ensighten-udnssdk-dev - ultradns SDK for golang
golang-github-erikdubbelboer-gspt-dev - setproctitle for Go
golang-github-erikstmartin-go-testdb-dev - Framework for stubbing responses from go's driver.Driver interface
golang-github-euank-go-kmsg-parser-dev - simpler parser for the /dev/kmsg format (library)
golang-github-evanphx-json-patch-dev - Go library to apply RFC6902 patches and create and apply RFC7386 patches
golang-github-evanw-esbuild-dev - extremely fast JavaScript bundler and minifier (library)
golang-github-evilsocket-ftrace-dev - trace Linux syscalls using the FTRACE kernel framework
golang-github-evilsocket-islazy-dev - Set of opinionated packages, objects, helpers and functions
golang-github-evilsocket-recording-dev - Allows reading and writing bettercap's session recordings
golang-github-expediadotcom-haystack-client-go-dev - Haystack bindings for OpenTracing API in Go (library)
golang-github-exponent-io-jsonpath-dev - Extension for Go's json.Decoder enabling navigation of a stream of tokens
golang-github-facebook-ent-dev - entity framework for Go
golang-github-facebookgo-atomicfile-dev - Provides an atomically written/replaced file
golang-github-facebookgo-clock-dev - Clock is a small Go library for mocking time
golang-github-facebookgo-ensure-dev - Provides utilities for testing to ensure conditions are met
golang-github-facebookgo-freeport-dev - Go library to find a free TCP port for binding
golang-github-facebookgo-grace-dev - Graceful restart & zero downtime deploy for Go servers
golang-github-facebookgo-httpdown-dev - Gracefully shut down daemon without terminating connections
golang-github-facebookgo-inject-dev - reflect based injector
golang-github-facebookgo-pidfile-dev - Package pidfile manages pid files.
golang-github-facebookgo-stack-dev - Stack provides utilities to capture and handle stack traces
golang-github-facebookgo-stats-dev - defines a lightweight interface for collecting statistics
golang-github-facebookgo-structtag-dev - provides parsing of the defacto struct tag style
golang-github-facebookgo-subset-dev - Check if a value is a subset of another
golang-github-facette-natsort-dev - natural strings sorting in Go
golang-github-farsightsec-go-nmsg-dev - Go implementation of the nmsg network message encapsulation library
golang-github-farsightsec-golang-framestream-dev - Frame Streams implementation in Go
golang-github-fatih-color-dev - console colors for Go
golang-github-fatih-set-dev - Set data structure for Go (library)
golang-github-fatih-structs-dev - Utilities for Go structs
golang-github-felixge-fgprof-dev - sampling Go profiler for analyzing On-CPU and Off-CPU
golang-github-fernet-fernet-go-dev - Go library for generates/verifies HMAC-based authentication tokens
golang-github-fhs-go-netrc-dev - netrc file parser for Go programming language
golang-github-fhs-gompd-dev - MPD client library
golang-github-filosottile-b2-dev - efficient, idiomatic Go library for Backblaze B2 Cloud Storage
golang-github-flosch-pongo2.v4-dev - Django-syntax like template-engine for Go (library)
golang-github-fluent-fluent-logger-golang-dev - Go structured logger for Fluentd
golang-github-fluffle-goirc-dev - Event-based stateful IRC client framework for Go.
golang-github-flynn-json5-dev - Go JSON5 decoder package based on encoding/json
golang-github-flynn-noise-dev - Go implementation of the Noise Protocol Framework (library)
golang-github-fogleman-gg-dev - Go Graphics - 2D rendering in Go with a simple API
golang-github-fortytw2-leaktest-dev - Goroutine Leak Detector
golang-github-francoispqt-gojay-dev - JSON encoder/decoder golang library with powerful stream API
golang-github-franela-goblin-dev - minimal and beautiful Go testing framework
golang-github-franela-goreq-dev - minimal and simple request library for Go language
golang-github-frankban-quicktest-dev - quick helpers for testing Go applications
golang-github-fsnotify-fsnotify-dev - File system notifications for Go
golang-github-fsouza-go-dockerclient-dev - Docker client library in Go
golang-github-fullsailor-pkcs7-dev - Implements a subset of PKCS#7/Crytpographic Message Syntax (rfc2315, rfc5652) (library)
golang-github-fvbommel-sortorder-dev - sort orders and comparison functions
golang-github-fxamacker-cbor-dev - CBOR codec implementing RFCs 7049 & 8949 (library)
golang-github-fzambia-eagle-dev - aggregate Prometheus metrics over time interval
golang-github-fzambia-sentinel-dev - Redis Sentinel support for redigo library
golang-github-gabriel-vasile-mimetype-dev - fast Go library for detecting MIME types and extensions based on magic numbers
golang-github-gambol99-go-marathon-dev - Library for working with Marathon
golang-github-garyburd-redigo-dev - Go client for Redis
golang-github-gcla-deep-dev - Golang deep variable equality test that returns human-readable differences
golang-github-gcla-gowid-dev - Compositional widgets for terminal user interfaces, inspired by urwid
golang-github-gcp-guest-logging-go-dev - Logging helpers for Google Cloud Platform agent (library)
golang-github-gdamore-encoding-dev - Various character map encodings missing from golang.org/x/net/encoding
golang-github-gdamore-tcell-dev - cell based view for text terminals
golang-github-gdamore-tcell.v2-dev - cell based view for text terminals
golang-github-gedex-inflector-dev - Go library that pluralizes and singularizes English nouns
golang-github-geertjohan-go.incremental-dev - Go package providing type- and concurrency-safe incremental counters
golang-github-geertjohan-go.rice-dev - Go package for embedding web resources into Go executables
golang-github-getkin-kin-openapi-dev - OpenAPI 3.0 implementation for Go
golang-github-getlantern-context-dev - goroutine-based context state
golang-github-getlantern-errors-dev - Structured errors for Go
golang-github-getlantern-hex-dev - Configurable hex encoding
golang-github-getlantern-hidden-dev - Hide text in text
golang-github-getlantern-ops-dev - Track success or failure of operations in code
golang-github-getsentry-raven-go-dev - Go client for the Sentry event/error logging system
golang-github-getsentry-sentry-go-dev - Official Sentry SDK for Go (library)
golang-github-ghodss-yaml-dev - better way to marshal and unmarshal YAML in Golang
golang-github-gigawattio-window-dev - Go library to generate a rolling window for a sequence of strings
golang-github-gin-contrib-cors-dev - Gin middleware/handler to enable CORS support
golang-github-gin-contrib-gzip-dev - Gin middleware to enable GZIP support
golang-github-gin-contrib-sse-dev - Server-Sent Events implementation in Go
golang-github-gin-contrib-static-dev - webserver for static files
golang-github-gin-gonic-gin-dev - HTTP web framework written in Go
golang-github-git-lfs-git-lfs-dev - Git Large File Support (library)
golang-github-git-lfs-gitobj-dev - gitobj reads and writes Git objects.
golang-github-git-lfs-go-netrc-dev - netrc file parser for Go programming language
golang-github-git-lfs-pktline-dev - Toolkit for the Git pkt-line format (library)
golang-github-git-lfs-wildmatch-dev - Pattern matching language for filepaths compatible with Git
golang-github-glacjay-goini-dev - INI file parser library for Go
golang-github-gliderlabs-ssh-dev - Easy SSH servers in Golang
golang-github-glycerine-go-unsnap-stream-dev - library for decoding the snappy streaming format
golang-github-gmazoyer-peeringdb-dev - PeeringDB API package for Go
golang-github-go-chef-chef-dev - Chef-Server API client in golang
golang-github-go-chi-chi-dev - lightweight, idiomatic and composable router for building Go HTTP services
golang-github-go-chi-cors-dev - CORS net/http middleware for Go
golang-github-go-co-op-gocron-dev - easy and fluent Go cron scheduling
golang-github-go-debos-fakemachine-dev - create and spawn virtual machines for building images with debos
golang-github-go-easygen-easygen-dev - Easy to use universal code/text generator -- source
golang-github-go-enry-go-license-detector-dev - Reliable project licenses detector (library)
golang-github-go-errors-errors-dev - errors with stacktraces for go
golang-github-go-git-go-billy-dev - missing interface filesystem abstraction for Go
golang-github-go-git-go-git-dev - highly extensible Git implementation in pure Go
golang-github-go-git-go-git-fixtures-dev - Several git fixtures to run go-git tests
golang-github-go-ini-ini-dev - Go package for control of INI file
golang-github-go-kit-kit-dev - Programming toolkit for microservices
golang-github-go-kit-log-dev - minimal and extensible structured logger (Go library)
golang-github-go-ldap-ldap-dev - Basic LDAP v3 functionality for the Go programming language
golang-github-go-log-log-dev - universal log interface for GO language (library)
golang-github-go-logfmt-logfmt-dev - Marshals and unmarshals logfmt messages
golang-github-go-logr-logr-dev - simple logging interface for Go (library)
golang-github-go-macaron-bindata-dev - in-memory static and template files for Macaron
golang-github-go-macaron-binding-dev - request data binding and validation middleware for Macaron
golang-github-go-macaron-csrf-dev - generate and validate csrf tokens for Macaron
golang-github-go-macaron-gzip-dev - Gzip middleware for Macaron
golang-github-go-macaron-i18n-dev - Internationalization and Localization of Macaron
golang-github-go-macaron-inject-dev - utilities for mapping and injecting dependencies
golang-github-go-macaron-session-dev - session management middleware for Macaron
golang-github-go-macaron-toolbox-dev - health check, pprof, profile and statistic services for Macaron
golang-github-go-macaroon-bakery-macaroonpb-dev - Protobuf encoding used by macaroon-bakery (library)
golang-github-go-openapi-analysis-dev - OpenAPI Specification object model analyser
golang-github-go-openapi-errors-dev - common error handling code for OpenAPI
golang-github-go-openapi-inflect-dev - golang library providing functions applying grammar rules to English words
golang-github-go-openapi-jsonpointer-dev - fork of gojsonpointer with support for structs (Go library)
golang-github-go-openapi-jsonreference-dev - implementation of gojsonreference with struct support
golang-github-go-openapi-loads-dev - OpenAPI Specification object model
golang-github-go-openapi-runtime-dev - OpenAPI runtime interfaces
golang-github-go-openapi-spec-dev - OpenAPI specification object model
golang-github-go-openapi-strfmt-dev - OpenAPI string formatting library
golang-github-go-openapi-swag-dev - goodie bag in use in the go-openapi projects
golang-github-go-openapi-validate-dev - OpenAPI toolkit validation helpers
golang-github-go-ping-ping-dev - simple but powerful ICMP echo (ping) library for Go
golang-github-go-piv-piv-go-dev - Keys and certificates for YubiKeys, written in Go (library)
golang-github-go-playground-assert-v2-dev - basic assertion library for Go
golang-github-go-playground-locales-dev - set of locales generated from the CLDR Project
golang-github-go-playground-universal-translator-dev - translator for Go using CLDR data and pluralization rules
golang-github-go-playground-validator-v10-dev - Go library for struct and field validation
golang-github-go-redis-redis-dev - Type safe Redis client for Go
golang-github-go-restruct-restruct-dev - Rich binary (de)serialization library for Golang (library)
golang-github-go-resty-resty-dev - Simple HTTP and REST client library for Go
golang-github-go-sourcemap-sourcemap-dev - source maps consumer for Golang
golang-github-go-sql-driver-mysql-dev - MySQL-Driver for Go's database/sql package
golang-github-go-stack-stack-dev - capture, manipulate, and format call stacks
golang-github-go-test-deep-dev - Golang deep variable equality test that returns human-readable differences
golang-github-go-xorm-builder-dev - SQL builder for XORM written in Go
golang-github-go-xorm-core-dev - lightweight wrapper of database/sql
golang-github-gobuffalo-envy-dev - simplify working with ENV variables
golang-github-gobuffalo-flect-dev - Inflection engine for Golang
golang-github-goburrow-modbus-dev - fault-tolerant implementation of modbus protocol
golang-github-goburrow-serial-dev - serial library for modbus written in Go
golang-github-gobwas-glob-dev - Go glob pattern library
golang-github-gocarina-gocsv-dev - easy CSV serialization and deserialization golang package
golang-github-goccy-go-yaml-dev - yet another golang library for YAML support
golang-github-gocql-gocql-dev - fast and robust Cassandra client for Go
golang-github-gofrs-flock-dev - thread-safe file locking library in Golang
golang-github-gofrs-uuid-dev - UUID library for Golang
golang-github-gogetdata-ggd-utils-dev - library for use in ggd
golang-github-gogits-chardet-dev - Charset detector library for Go
golang-github-gogits-cron-dev - Gogs cron library in Go
golang-github-gogits-go-gogs-client-dev - Gogs API client in Go
golang-github-gogo-googleapis-dev - googleapis generated with gogoprotobuf
golang-github-gogo-protobuf-dev - alternative protocol buffer support for Golang - sources
golang-github-gogo-status-dev - gRPC-like status package for use with GoGo Protobuf types
golang-github-goji-httpauth-dev - HTTP Authentication middleware
golang-github-goji-param-dev - Rack / jQuery style parameter parsing for Go
golang-github-gokyle-fswatch-dev - simple UNIX file system watching library in Go
golang-github-gokyle-twofactor-dev - Two-factor authentication
golang-github-golang-freetype-dev - Freetype font rasterizer in the Go programming language
golang-github-golang-groupcache-dev - caching and cache-filling library, a replacement for memcached
golang-github-golang-jwt-jwt-dev - golang implementation of JSON Web Tokens (library)
golang-github-golang-leveldb-dev - Implementation of the LevelDB key/value database in Go
golang-github-golang-mock-dev - mocking framework for the Go programming language
golang-github-golang-snappy-dev - Implementation of the Snappy compression format in Go
golang-github-gologme-log-dev - A fork of the golang built in log package to add support for levels (library)
golang-github-gomodule-oauth1-dev - OAuth 1.0 client package for Go
golang-github-gomodule-redigo-dev - Go client for Redis
golang-github-google-blueprint-dev - Blueprint meta build system (library)
golang-github-google-btree-dev - BTree implementation for Go
golang-github-google-cadvisor-dev - analyze resource usage and performance of running containers
golang-github-google-certificate-transparency-dev - Framework for monitoring and auditing SSL certificates
golang-github-google-go-cmp-dev - Package for comparing Go values in tests
golang-github-google-go-dap-dev - Go implementation of the Debug Adapter Protocol (library)
golang-github-google-go-github-dev - Go library for accessing the GitHub API
golang-github-google-go-intervals-dev - Functions for set operations on intervals, like ranges (library)
golang-github-google-go-querystring-dev - library for encoding structs into URL query parameters
golang-github-google-gofuzz-dev - Fuzz testing for Go
golang-github-google-gopacket-dev - packet capturing and decoding library for Go
golang-github-google-gousb-dev - provides low-level interface for accessing USB devices (library)
golang-github-google-jsonapi-dev - jsonapi.org style payload serializer and deserializer
golang-github-google-martian-dev - Martian is a library for building custom HTTP/S proxies
golang-github-google-pprof-dev - pprof is a tool for visualization and analysis of profiling data
golang-github-google-renameio-dev - provides a way to atomically create or replace a file or symbolic link
golang-github-google-shlex-dev - Simple lexer for Go that supports shell-style rules
golang-github-google-subcommands-dev - go package for add some subcommands to single command
golang-github-google-uuid-dev - generates and inspects UUIDs based on RFC 4122
golang-github-google-wire-dev - Compile-time Dependency Injection for Go (library)
golang-github-googleapis-gax-go-dev - Google API Extensions for Go
golang-github-googleapis-gnostic-dev - compiler for OpenAPI specification - library
golang-github-googlecloudplatform-cloudsql-proxy-dev - connect securely to a 2nd generation Cloud SQL DB (Go library)
golang-github-googlecloudplatform-guest-logging-go-dev - Go logging package with Google Cloud Platform interface (library)
golang-github-goombaio-namegenerator-dev - random name generator implementation in Golang
golang-github-gopasspw-pinentry-dev - Pinentry client in Go (library)
golang-github-gophercloud-gophercloud-dev - OpenStack SDK for Go
golang-github-gophercloud-utils-dev - utils for OpenStack Go library
golang-github-gopherjs-gopherjs-dev - Go to Javascript compiler
golang-github-gopherjs-jsbuiltin-dev - GopherJS bindings for built-in JavaScript functions
golang-github-gorhill-cronexpr-dev - cron expression parser
golang-github-gorilla-context-dev - General purpose registry for global request variables
golang-github-gorilla-csrf-dev - Cross Site Request Forgery (CSRF) prevention middleware for Go
golang-github-gorilla-css-dev - CSS3 tokenizer for Go (library)
golang-github-gorilla-handlers-dev - collection of useful handlers for Go's net/http package
golang-github-gorilla-mux-dev - powerful URL router and dispatcher for golang
golang-github-gorilla-pat-dev - request router and dispatcher with a pat-like interface
golang-github-gorilla-rpc - Transitional package for golang-github-gorilla-rpc-dev
golang-github-gorilla-rpc-dev - golang foundation for RPC over HTTP services
golang-github-gorilla-securecookie-dev - provides authenticated and encrypted cookie values
golang-github-gorilla-sessions-dev - save cookie and filesystem sessions and allow custom session backends
golang-github-gorilla-websocket-dev - Go package implementing the WebSocket protocol
golang-github-gosexy-gettext-dev - Gettext support for the Go language
golang-github-gosnmp-gosnmp-dev - SNMP library written in Go
golang-github-gosuri-uilive-dev - Go library for updating terminal output in realtime
golang-github-gosuri-uiprogress-dev - Go library to render progress bars in terminal applications
golang-github-gosuri-uitable-dev - go library to improve readability in terminal apps using tabular data
golang-github-gotestyourself-gotest.tools-dev - collection of go packages to support common testing patterns
golang-github-gotk3-gotk3-dev - Go bindings for GTK3
golang-github-grafana-grafana-plugin-model-dev - models for Grafana backend plugins
golang-github-graph-gophers-graphql-go-dev - GraphQL server with a focus on ease of use
golang-github-gravitational-trace-dev - Package for error handling and error reporting
golang-github-graylog2-go-gelf-dev - GELF library and writer for Go
golang-github-greatroar-blobloom-dev - Blocked Bloom filters for Go
golang-github-gregjones-httpcache-dev - Transport for http.Client that will cache responses
golang-github-grokify-html-strip-tags-go-dev - Golang library to HTML StripTags
golang-github-grpc-ecosystem-go-grpc-middleware-dev - Go gRPC Middlewares: interceptor chaining, auth, logging, retries and more
golang-github-grpc-ecosystem-go-grpc-prometheus-dev - Prometheus monitoring for gRPC Go servers
golang-github-grpc-ecosystem-grpc-gateway-dev - gRPC to JSON proxy generator for Golang -- sources
golang-github-grpc-ecosystem-grpc-opentracing-dev - expressive vendor-neutral APIs for distributed tracing and context propagation
golang-github-gtank-cryptopasta-dev - copy & paste-friendly golang crypto
golang-github-gucumber-gucumber-dev - Cucumber BDD-style testing for Go -- source
golang-github-guptarohit-asciigraph-dev - Make lightweight ASCII line graph in CLI apps with no other dependencies
golang-github-h2non-parth-dev - Path parsing for segment unmarshaling and slicing
golang-github-hailocab-go-hostpool-dev - flexibly pool among multiple hosts from Go application
golang-github-hansrodtang-randomcolor-dev - random color generator
golang-github-hanwen-go-fuse-dev - Native Go bindings for the FUSE kernel module
golang-github-hanwen-usb-dev - CGO bindings for libusb
golang-github-hashicorp-atlas-go-dev - official Go client for HashiCorp's Atlas
golang-github-hashicorp-consul-dev - tool for service discovery, monitoring and configuration (source)
golang-github-hashicorp-errwrap-dev - Errwrap is a Go (golang) library for wrapping and querying errors
golang-github-hashicorp-go-azure-helpers-dev - various helpers and wrappers for working with Azure
golang-github-hashicorp-go-bexpr-dev - generic boolean expression evaluation in Golang
golang-github-hashicorp-go-checkpoint-dev - Go Checkpoint Client
golang-github-hashicorp-go-cleanhttp-dev - Functions for accessing "clean" Go http.Client values
golang-github-hashicorp-go-discover-dev - discover nodes in cloud environments
golang-github-hashicorp-go-envparse-dev - Minimal environment variable parser for Go (library)
golang-github-hashicorp-go-gcp-common-dev - common code shared by GCP-maintained plugins
golang-github-hashicorp-go-getter-dev - download from a URL using a variety of protocols
golang-github-hashicorp-go-hclog-dev - common logging package for HashiCorp tools
golang-github-hashicorp-go-immutable-radix-dev - immutable radix tree implementation in Golang
golang-github-hashicorp-go-memdb-dev - in-memory database built on immutable radix trees
golang-github-hashicorp-go-msgpack-dev - encode/decode and rpc library for msgpack and Binc
golang-github-hashicorp-go-multierror-dev - Go package for representing a list of errors as a single error
golang-github-hashicorp-go-plugin-dev - Golang plugin system over RPC
golang-github-hashicorp-go-raftchunking-dev - chunking middleware for use by Raft clients
golang-github-hashicorp-go-reap-dev - child process reaping utilities for Go
golang-github-hashicorp-go-retryablehttp-dev - retryable HTTP client in Go
golang-github-hashicorp-go-rootcerts-dev - functions for loading root certificates for TLS connections
golang-github-hashicorp-go-safetemp-dev - Functions for working safely with temporary files and directories
golang-github-hashicorp-go-slug-dev - functions to create slug archives
golang-github-hashicorp-go-sockaddr-dev - IP address/UNIX socket convenience functions for Go
golang-github-hashicorp-go-syslog-dev - Golang syslog wrapper, cross-compile friendly
golang-github-hashicorp-go-tfe-dev - Terraform Cloud/Enterprise API Client/SDK in Golang
golang-github-hashicorp-go-uuid-dev - generate UUID-format strings using high quality random bytes
golang-github-hashicorp-go-version-dev - library for parsing and verifying versions and version constraints
golang-github-hashicorp-golang-lru-dev - Golang LRU cache
golang-github-hashicorp-hcl-dev - Go implementation of HashiCorp Configuration Language
golang-github-hashicorp-hil-dev - small embedded language for string interpolations
golang-github-hashicorp-logutils-dev - Utilities for slightly better logging in Go
golang-github-hashicorp-mdns-dev - simple mDNS client/server library in Golang
golang-github-hashicorp-memberlist-dev - Golang package for gossip based membership and failure detection
golang-github-hashicorp-net-rpc-msgpackrpc-dev - Library for creating Go RPC client/server
golang-github-hashicorp-raft-boltdb-dev - Raft backend implementation using BoltDB
golang-github-hashicorp-raft-dev - implementation of the Raft consensus protocol
golang-github-hashicorp-scada-client-dev - Golang client to the HashiCorp SCADA system
golang-github-hashicorp-serf-dev - Service orchestration and management tool (source)
golang-github-hashicorp-terraform-json-dev - helper types for the Terraform external data representation
golang-github-hashicorp-terraform-plugin-test-dev - helper library for testing Terraform plugins
golang-github-hashicorp-terraform-svchost-dev - handling of friendly hostnames for terraform
golang-github-hashicorp-yamux-dev - Golang connection multiplexing library
golang-github-hawkular-hawkular-client-go-dev - Golang client for Hawkular
golang-github-haya14busa-go-checkstyle-dev - Golang checkstyle module (library)
golang-github-haya14busa-go-sarif-dev - Go structs for the SARIF object model (library)
golang-github-hdrhistogram-hdrhistogram-go-dev - pure Go implementation of Gil Tene's HDR Histogram
golang-github-hectane-go-acl-dev - Go library for manipulating ACLs on Windows
golang-github-henrydcase-nobs-dev - NOBS cryptographic primitives library in golang
golang-github-henvic-httpretty-dev - Prints HTTP requests made with Go pretty on your terminal.
golang-github-heroku-rollrus-dev - Logrus Rollbar Hook
golang-github-hetznercloud-hcloud-go-dev - library for the Hetzner Cloud API
golang-github-hhatto-gorst-dev - Go implementation of reStructuredText
golang-github-hillu-go-yara-dev - Go bindings for YARA
golang-github-hinshun-vt10x-dev - vt10x terminal emulation backend
golang-github-hjfreyer-taglib-go-dev - audio tag library in the spirit of taglib
golang-github-hjson-hjson-go-dev - Hjson for Go (library)
golang-github-hlandau-buildinfo-dev - Go build information utilities
golang-github-hlandau-dexlogconfig-dev - logging configuration package for Go
golang-github-hlandau-goutils-dev - miscellaneous Go utility packages
golang-github-hlandau-xlog-dev - logging library for Go
golang-github-hmrc-vmware-govcd-dev - vCloud Air API bindings for Golang
golang-github-hodgesds-perf-utils-dev - Perf Utilities for Go (library)
golang-github-howeyc-gopass-dev - getpasswd for Go
golang-github-htcat-htcat-dev - Parallel and Pipelined HTTP GET Utility for golang
golang-github-huandu-go-assert-dev - Magic assert macros for Go
golang-github-huandu-xstrings-dev - Package xstrings: A collection of useful string functions in Go.
golang-github-huin-goupnp-dev - UPnP library for Go
golang-github-hydrogen18-stalecucumber-dev - Reader and writer for Python's pickle format in Golang
golang-github-hydrogen18-stoppablelistener-dev - stoppable TCP listener in Go
golang-github-iafan-cwalk-dev - Concurrent filepath.Walk replacement
golang-github-ianbruene-go-difflib-dev - partial port of Python difflib package to Go
golang-github-iancoleman-orderedmap-dev - Golang map where the keys keep the order that they're added
golang-github-ianlancetaylor-demangle-dev - C++ symbol name demangler written in Go
golang-github-icrowley-fake-dev - fake data generator for Golang
golang-github-icza-gox-dev - Minimalist extension to Go that complements the standard library (library)
golang-github-igm-pubsub-dev - simple PubSub mechanism for GO
golang-github-igm-sockjs-go-dev - WebSocket emulation - Go server library
golang-github-imdario-mergo-dev - Functions to merge structs and maps in Go
golang-github-inconshreveable-go-update-dev - Build self-updating Golang programs
golang-github-inconshreveable-log15-dev - structured, composable logging for Go
golang-github-inconshreveable-mousetrap-dev - Go library to detect starting from Windows Explorer
golang-github-inconshreveable-muxado-dev - Stream multiplexing for Go
golang-github-inexio-go-monitoringplugin-dev - Go lib for writing monitoring check plugins
golang-github-influxdata-go-syslog-dev - Go parser for syslog messages
golang-github-influxdata-influxql-dev - parser for the InfluxDB query language
golang-github-influxdata-line-protocol-dev - InfluxDB line protocol implementation
golang-github-influxdata-tail-dev - Go package for reading from continuously updated files (tail -f)
golang-github-influxdata-tdigest-dev - Ted Dunning's t-digest in Go
golang-github-influxdata-toml-dev - TOML parser and encoder library for Golang
golang-github-influxdata-wlog-dev - simple log level based Golang logger
golang-github-influxdata-yamux-dev - Golang connection multiplexing library
golang-github-influxdata-yarpc-dev - Yet Another RPC for Go - dev package
golang-github-influxdb-enterprise-client-dev - Golang client for speaking to the InfluxDB Enterprise application
golang-github-influxdb-influxdb-dev - Scalable datastore for metrics, events, and real-time analytics. Dev package
golang-github-influxdb-usage-client-dev - library for speaking to the InfluxDB Anonymous Usage Reporting API
golang-github-insomniacslk-dhcp-dev - DHCPv6 and DHCPv4 packet library, client and server written in Go (library)
golang-github-integrii-flaggy-dev - Idiomatic Go input parsing with subcommands, positional values, and flags
golang-github-intel-go-cpuid-dev - Intel CPUID library for Go Programming Language
golang-github-intel-goresctrl-dev - Go library for managing resctrl filesystem
golang-github-intel-tfortools-dev - template scripting support to go programs
golang-github-ishidawataru-sctp-dev - SCTP library for the Go programming language
golang-github-issue9-assert-dev - Simple extension to test a series of assert functions
golang-github-issue9-identicon-dev - generate an icon from identity information
golang-github-itchyny-go-flags-dev - Go library for parsing command line arguments (itchyny's fork)
golang-github-itchyny-gojq-dev - pure Go implementation of jq (library)
golang-github-itchyny-timefmt-go-dev - Efficient time formatting library (strftime, strptime) for Go
golang-github-ivpusic-grpool-dev - Lightweight Goroutine pool
golang-github-j-keck-arping-dev - library to ping a host per arp datagram or query a host mac address
golang-github-jackc-fake-dev - fake data generator for Golang
golang-github-jackc-pgx-dev - PostgreSQL driver and toolkit for Golang
golang-github-jackpal-gateway-dev - library for discovering the address of a LAN gateway
golang-github-jackpal-go-nat-pmp-dev - client for the NAT-PMP internet protocol
golang-github-jacobsa-bazilfuse-dev - fork of bazil.org/fuse for gcsfuse
golang-github-jacobsa-crypto-dev - Some Go cryptography routines that are not included in the Go standard library
golang-github-jacobsa-fuse-dev - writing and mounting user-space file systems from Go
golang-github-jacobsa-gcloud-dev - convenience wrapper around google cloud platform APIs
golang-github-jacobsa-oglematchers-dev - matchers for testing/mocking frameworks such as ogletest
golang-github-jacobsa-oglemock-dev - mocking framework for Go
golang-github-jacobsa-ogletest-dev - unit testing framework for Go
golang-github-jacobsa-reqtrace-dev - simple request tracing
golang-github-jacobsa-syncutil-dev - code that supplements the Go stdlib sync package
golang-github-jacobsa-timeutil-dev - code supplementing Go's time package
golang-github-jacobsa-util-dev - utility code for jacobsa projects
golang-github-jaguilar-vt100-dev - raw-mode vt100 screen reader
golang-github-jamesclonk-vultr-dev - Vultr API client library
golang-github-jamiealquiza-tachymeter-dev - Go library for timing things and yielding rates, percentiles, and histograms
golang-github-jarcoal-httpmock-dev - HTTP mocking for Golang
golang-github-jasonish-go-idsrules-dev - Go IDS rule parser
golang-github-jaypipes-pcidb-dev - Small golang library for querying PCI database (pciids) information (library)
golang-github-jaytaylor-html2text-dev - Turns HTML into a plain-text equivalent
golang-github-jbenet-go-context-dev - context.Context extensions
golang-github-jcmturner-gofork-dev - forked and modified go standard library packages to work around issues
golang-github-jdkato-prose-dev - Golang library for text processing
golang-github-jdkato-syllables-dev - Go syllable counter
golang-github-jedib0t-go-pretty-dev - Pretty print tables, lists, progress-bars and text
golang-github-jedisct1-dlog-dev - Super simple logger for Go
golang-github-jedisct1-go-clocksmith-dev - Go sleep-aware sleep() function
golang-github-jedisct1-go-dnsstamps-dev - DNS Stamps library for Go
golang-github-jedisct1-go-minisign-dev - Minisign library for Golang
golang-github-jedisct1-xsecretbox-dev - Go implementation of crypto_secretbox_xchacha20poly1305
golang-github-jeffail-gabs-dev - For parsing, creating and editing unknown or dynamic JSON in Go
golang-github-jefferai-jsonx-dev - Object or JSON -> JSONx
golang-github-jeromer-syslogparser-dev - syslog parser library
golang-github-jesseduffield-asciigraph-dev - Go package to make lightweight ASCII line graph without dependencies
golang-github-jesseduffield-go-getter-dev - download from a URL using a variety of protocols
golang-github-jesseduffield-gocui-dev - minimalist console user interfaces Go library
golang-github-jesseduffield-pty-dev - Go package for using Unix pseudo-terminals
golang-github-jesseduffield-roll-dev - Simple(er) Rollbar client for Go
golang-github-jesseduffield-rollrus-dev - Logrus Rollbar Hook
golang-github-jesseduffield-termbox-go-dev - pure Go implementation of termbox library
golang-github-jesseduffield-yaml-dev - YAML support for the Go language
golang-github-jessevdk-go-flags-dev - Go library for parsing command line arguments
golang-github-jfbus-httprs-dev - ReadSeeker for http.Response.Body
golang-github-jfrazelle-go-dev - Transitional package for golang-github-docker-go-dev
golang-github-jhoonb-archivex-dev - archives folders (recursively) and files to zip and tar formats
golang-github-jimstudt-http-authentication-dev - Go implementation of RFC 2617 HTTP Authentication
golang-github-jinzhu-copier-dev - Copy value from struct to struct and more (library)
golang-github-jinzhu-gorm-dev - ORM library for Golang
golang-github-jinzhu-inflection-dev - pluralize and singularize English nouns
golang-github-jinzhu-now-dev - time toolkit for golang
golang-github-jkeiser-iter-dev - Go library for iteration (library)
golang-github-jlaffaye-ftp-dev - FTP client package for Go
golang-github-jmespath-go-jmespath-dev - Golang implementation of JMESPath
golang-github-jmhodges-clock-dev - Go package for testing time-dependent code
golang-github-jmoiron-sqlx-dev - General purpose extensions to Golang's database/sql library
golang-github-jochenvg-go-udev-dev - Go bindings for libudev (library)
golang-github-joho-godotenv-dev - Go port of Ruby's dotenv library
golang-github-jonas-p-go-shp-dev - library for reading and writing ESRI Shapefiles
golang-github-jonboulle-clockwork-dev - Simple fake clock for Go
golang-github-josharian-intern-dev - Intern string golang library
golang-github-josharian-native-dev - Easy to use native encoding/binary.ByteOrder (library)
golang-github-jouyouyun-hardware-dev - Golang Library for Get hardware info
golang-github-joyent-gocommon-dev - common Go library for Joyent's Triton and Manta
golang-github-joyent-gosdc-dev - Go library for interaction with the Joyent CloudAPI
golang-github-joyent-gosign-dev - Go HTTP signing library for Joyent's Triton and Manta
golang-github-jpillora-backoff-dev - backoff algorithm in Golang
golang-github-jpillora-go-tld-dev - Top Level Domain (TLD) Parser
golang-github-jroimartin-gocui-dev - Minimalist Go package aimed at creating Console User Interfaces
golang-github-jsimonetti-rtnetlink-dev - low-level access to the Linux rtnetlink API (library)
golang-github-json-iterator-go-dev - High-performance drop-in replacement of "encoding/json"
golang-github-jsternberg-zap-logfmt-dev - logfmt for zap
golang-github-jtacoma-uritemplates-dev - URI Templates (RFC 6570) implemented in Go
golang-github-jteeuwen-go-bindata-dev - embed data in a Go program - library package
golang-github-jtolds-gls-dev - Goroutine local storage
golang-github-juju-ansiterm-dev - colored writers and tabwriters
golang-github-juju-clock-dev - Clock definition and a testing clock (library)
golang-github-juju-cmd-dev - Command line implementation framework (library)
golang-github-juju-collections-dev - Deque and set implementations (library)
golang-github-juju-errors-dev - Common juju errors and functions to annotate errors
golang-github-juju-gnuflag-dev - GNU-compatible flag handling with a stdlib-like API for Go (library)
golang-github-juju-gomaasapi-dev - Go bindings for talking to MAAS (library)
golang-github-juju-httpprof-dev - fork of net/http/pprof which works when not at the server's root
golang-github-juju-loggo-dev - logging library for Go
golang-github-juju-mutex-dev - Provides a named machine level mutex shareable between processes (library)
golang-github-juju-names-dev - Package to deal with juju names (services, units, machines, etc) (library)
golang-github-juju-persistent-cookiejar-dev - fork of net/http/cookiejar that allows serialisation of cookies (library)
golang-github-juju-qthttptest-dev - Check that JSON HTTP endpoints respond appropriately (library)
golang-github-juju-ratelimit-dev - Efficient token-bucket-based rate limiter module for Go
golang-github-juju-retry-dev - encapsulates the mechanism around retrying commands
golang-github-juju-schema-dev - coerce dynamically typed data structures into known forms (library)
golang-github-juju-simplekv-dev - Naive key-value store with multiple backends (library)
golang-github-juju-testing-dev - Testing gocheck suites and checkers used across juju projects (library)
golang-github-juju-usso-dev - Ubuntu single sign-on library
golang-github-juju-utils-dev - General utility functions
golang-github-juju-version-dev - intelligent version comparisons (library)
golang-github-juju-webbrowser-dev - Go helpers for interacting with Web browsers (library)
golang-github-julienschmidt-httprouter-dev - High performance HTTP request router for Go that scales well
golang-github-jung-kurt-gofpdf-dev - PDF document generator with high level support for text, drawing and images
golang-github-justinas-alice-dev - Painless middleware chaining for Go
golang-github-jwilder-encoding-dev - library for working with compressed arrays of integers
golang-github-jzelinskie-whirlpool-dev - whirlpool cryptographic hashing library
golang-github-k-sone-critbitgo-dev - crit-bit for golang and its applications (sorted map, IP routing table)
golang-github-k0kubun-colorstring-dev - Go library for colorizing strings for terminal output
golang-github-k0kubun-go-ansi-dev - Windows-portable ANSI escape sequence utility
golang-github-k0kubun-pp-dev - Go library to colored pretty printer on terminal
golang-github-k0swe-wsjtx-go-dev - Golang binding for the WSJT-X amateur radio software's UDP interface (library)
golang-github-kardianos-minwinsvc-dev - Stub for portability to Windows (library)
golang-github-kardianos-osext-dev - Extend "os" package with Executable and ExecutableFolder
golang-github-kardianos-service-dev - run Go programs as a service on major platforms
golang-github-karlseguin-ccache-dev - Golang LRU Cache for high concurrency
golang-github-karlseguin-expect-dev - Testing framework for Go with more concise syntax
golang-github-karrick-godirwalk-dev - Fast directory traversal for Golang (library)
golang-github-karrick-goswarm-dev - Memoization with asynchronous revalidation for Go
golang-github-kata-containers-govmm-dev - Provide Go APIs for creating and managing virtual machines
golang-github-kballard-go-shellquote-dev - Go utilities for performing shell-like word splitting/joining
golang-github-kelseyhightower-envconfig-dev - decode environment variables based on a user defined specification
golang-github-keltia-archive-dev - Small Go library for handling archives of various types.
golang-github-kelvins-sunrisesunset-dev - Go package that provides the sunrise and sunset equation. (library)
golang-github-kentik-patricia-dev - Garbage collector-sensitive patricia tree (library)
golang-github-kevinburke-ssh-config-dev - Go parser for ssh_config files
golang-github-kimor79-gollectd-dev - go parser for the collectd binary protocol
golang-github-kisielk-gotool-dev - library of some utility functions provided by cmd/go
golang-github-kisielk-sqlstruct-dev - convenience functions for using structs with the database/sql package
golang-github-kisom-goutils-dev - Various TLS certificate tools and other utility libraries for Golang
golang-github-kjk-lzma-dev - port of the lzma compression algorithm
golang-github-klauspost-compress-dev - optimized compression packages
golang-github-klauspost-cpuid-dev - CPU feature identification for Go
golang-github-klauspost-crc32-dev - CRC32 hash with x64 optimizations
golang-github-klauspost-pgzip-dev - parallel gzip (de)compression library for Go
golang-github-klauspost-reedsolomon-dev - Reed-Solomon Erasure Coding in Go
golang-github-knadh-koanf-dev - extensible library for reading config (file, S3 etc.) in Go applications
golang-github-knq-snaker-dev - methods to convert CamelCase to and from snake_case
golang-github-knqyf263-go-apk-version-dev - parsing apk package versions for golang
golang-github-knqyf263-go-cpe-dev - golang library for CPE (A Common Platform Enumeration 2.3)
golang-github-knqyf263-go-deb-version-dev - golang library for parsing deb package versions
golang-github-knqyf263-go-dep-parser-dev - Golang library for dependency parser
golang-github-knqyf263-go-rpm-version-dev - golang library for parsing rpm package versions
golang-github-knqyf263-go-rpmdb-dev - RPM DB library for go
golang-github-knqyf263-go-version-dev - Go library for parsing and verifying versions, and version constraints
golang-github-knqyf263-gost-dev - local copy tool of Security Tracker (Red Hat/Debian) written in go
golang-github-knqyf263-nested-dev - Golang library for easier way to handle the nested data structure
golang-github-kolo-xmlrpc-dev - Implementation of the XMLRPC client protocol in Go
golang-github-komkom-toml-dev - instream TOML to JSON encoder
golang-github-kong-go-kong-dev - Go binding for Kong's admin API (library)
golang-github-konsorten-go-windows-terminal-sequences-dev - Enable support for Windows Terminal Colors
golang-github-koofr-go-httpclient-dev - Go HTTP client
golang-github-koofr-go-koofrclient-dev - Go Koofr client
golang-github-kori-go-listenbrainz-dev - Go wrapper for the ListenBrainz API.
golang-github-kotakanbe-go-cve-dictionary-dev - builds a local copy of the NVD/JVN (source)
golang-github-kotakanbe-go-pingscanner-dev - Go library to scan live hosts by ping command
golang-github-kotakanbe-goval-dictionary-dev - Go library for create DB of data written in OVAL (source)
golang-github-kotakanbe-logrus-prefixed-formatter-dev - Go package for Logrus Prefixed Log Formatter
golang-github-kr-binarydist-dev - Go implementation of the bspatch algorithm
golang-github-kr-fs-dev - Provides filesystem-related functions for Go
golang-github-kr-pretty-dev - Pretty printing for Go values
golang-github-kr-pty-dev - Go package for using unix pseudo-terminals
golang-github-kr-text-dev - Go package for manipulating paragraphs of text
golang-github-kubernetes-gengo-dev - library for generating code based on Go files
golang-github-kurin-blazer-dev - Go library for Backblaze's B2
golang-github-kylelemons-godebug-dev - Debugging helper utilities for Go
golang-github-kyoh86-xdg-dev - helper functions in golang to get xdg config, data and cache files
golang-github-kyokomi-emoji-dev - Go library for printing emoji as Unicode characters
golang-github-la5nta-wl2k-go-dev - Winlink framework for Go (library)
golang-github-labstack-echo-dev - high performance, minimalist Go web framework
golang-github-labstack-echo.v2-dev - Echo is a fast and unfancy HTTP server framework for Golang
golang-github-labstack-echo.v3-dev - Echo is a fast and unfancy HTTP server framework for Golang
golang-github-labstack-gommon-dev - common package that provides parser, coloring, logging  for go
golang-github-leanovate-gopter-dev - GOlang Property TestER
golang-github-leemcloughlin-gofarmhash-dev - Implements Google's Farmhash in Golang
golang-github-leemcloughlin-jdn-dev - Julian Day Numbers for Go (library)
golang-github-leodido-go-urn-dev - Go parser for Uniform Resource Names
golang-github-leodido-ragel-machinery-dev - Machineries for development of ragel parsers
golang-github-lestrrat-go-envload-dev - environment variable manipulation library
golang-github-lestrrat-go-pdebug-dev - Print debugging library for Go
golang-github-lestrrat-go-strftime-dev - fast strftime implementation for Go (library)
golang-github-letsencrypt-challtestsrv-dev - ACME challenge mock server
golang-github-liamg-clinch-dev - Go library for interactive CLI applications
golang-github-liamg-gifwrap-dev - go library for displays GIF files in terminal
golang-github-liamg-tml-dev - terminal markup language library for Go
golang-github-lib-pq-dev - pure Go Postgres driver for Go??s database/sql package
golang-github-libdns-libdns-dev - Core interfaces for universal DNS record manipulation across providers
golang-github-libvirt-libvirt-go-dev - Go bindings for libvirt
golang-github-lightstep-lightstep-tracer-common-dev - files shared by most or all of the Lightstep tracer implementations
golang-github-linkedin-goavro-dev - library that encodes and decodes Avro data
golang-github-linuxdeepin-go-dbus-factory-dev - Go binding code for automatically generating DBus services (library)
golang-github-linuxdeepin-go-x11-client-dev - deepin go x11 client
golang-github-linuxkit-virtsock-dev - Go bindings for Hyper-V and virtio sockets
golang-github-lithammer-dedent-dev - Remove any common leading whitespace from multiline strings
golang-github-lithammer-fuzzysearch-dev - FuzzySearch provides tiny and fast fuzzy search
golang-github-lk4d4-joincontext-dev - Golang library to join contexts
golang-github-logrusorgru-aurora-dev - Golang ultimate ANSI-colors that supports Printf/Sprintf methods (library)
golang-github-logrusorgru-grokky-dev - pure Golang Grok-like library
golang-github-lpabon-godbc-dev - Design-by-contract library for Go
golang-github-lsegal-gucumber-dev - Transitional package for golang-github-gucumber-gucumber-dev
golang-github-lucas-clemente-quic-go-dev - QUIC golang library
golang-github-lucasb-eyer-go-colorful-dev - Library for handling color spaces in Go
golang-github-lunixbochs-vtclean-dev - strips terminal escapes from text, can preserve color
golang-github-lunny-log-dev - Logging library with sqlite support for Go
golang-github-lunny-nodb-dev - Nosql database with kv, list, hash, zset, bitmap, set
golang-github-m3db-prometheus-client-model-dev - data model artifacts for Prometheus
golang-github-machinebox-graphql-dev - simple low-level GraphQL HTTP client for Go
golang-github-magiconair-properties-dev - Java properties scanner for Go
golang-github-mailgun-minheap-dev - User-friendly heap container (library)
golang-github-mailgun-multibuf-dev - Seekable and persistable bytes buffer (library)
golang-github-mailgun-timetools-dev - Go library with various time utilities (library)
golang-github-mailgun-ttlmap-dev - In memory dictionary with TTLs (library)
golang-github-mailru-easyjson-dev - Fast JSON serializer for golang - development files
golang-github-makenowjust-heredoc-dev - Convert strings to here documents in Go
golang-github-makeworld-the-better-one-go-gemini-dev - Client library for the Gemini protocol, in Go
golang-github-makeworld-the-better-one-go-isemoji-dev - Go library to test if a string is an emoji
golang-github-malfunkt-iprange-dev - IPv4 address parser for the nmap format
golang-github-manifoldco-promptui-dev - Interactive prompt for command-line applications (library)
golang-github-manyminds-api2go-dev - JSONAPI.org implementation for Go
golang-github-maraino-go-mock-dev - mocking framework for the Go programming language
golang-github-markbates-goth-dev - Multi-provider authentication for Go
golang-github-markbates-inflect-dev - Go library to transform words from singular to plural (Git fork)
golang-github-marstr-collection-dev - implementation of a few basic data structures
golang-github-marten-seemann-qpack-dev - minimal QPACK implementation in Go
golang-github-marten-seemann-qtls-dev - TLS 1.3 implementation, modified for QUIC
golang-github-marten-seemann-qtls-go1-17-dev - Go standard library TLS 1.3 implementation, modified for QUIC (library)
golang-github-martinlindhe-base36-dev - Base36 implementation in golang (library)
golang-github-maruel-panicparse-dev - Crash your app in style (Golang)
golang-github-masahiro331-go-mvn-version-dev - Go library for parsing maven(java) package versions
golang-github-masterminds-goutils-dev - Go implementation of some string manipulation libraries of Apache Commons
golang-github-masterminds-semver-dev - Semantic versions library in Go
golang-github-masterminds-vcs-dev - VCS Repository Management for Go
golang-github-masterzen-simplexml-dev - Go library to generate XML content from a naive DOM
golang-github-masterzen-winrm-dev - Windows remote command execution library for Go
golang-github-masterzen-xmlpath-dev - subset of the XPath specification for Go (deprecated)
golang-github-matryer-is-dev - professional lightweight testing mini-framework for Go
golang-github-matryer-try-dev - Simple idiomatic retry package for Go
golang-github-mattermost-xml-roundtrip-validator-dev - mitigations for multiple security issues in encoding/xml
golang-github-mattetti-filebuffer-dev - implementation of a few file-like interfaces
golang-github-mattn-go-colorable-dev - Golang library to colorable writer for windows
golang-github-mattn-go-ieproxy-dev - Go package to detect the proxy settings on Windows platform (library)
golang-github-mattn-go-isatty-dev - Golang library to implementation isatty interface
golang-github-mattn-go-pointer-dev - utility for cgo
golang-github-mattn-go-runewidth-dev - functions to get fixed width of the character or string
golang-github-mattn-go-shellwords-dev - parse line as shell words in Golang
golang-github-mattn-go-sqlite3-dev - sqlite3 driver for go that using database/sql
golang-github-mattn-go-tty-dev - Go tty library
golang-github-mattn-go-unicodeclass-dev - Unicode class package (library)
golang-github-mattn-go-xmlrpc-dev - XML-RPC interface for Go (library)
golang-github-mattn-go-xmpp-dev - go xmpp library (library)
golang-github-mattn-go-zglob-dev - glob library that descends into other directories
golang-github-mb0-glob-dev - Configurable globbing and matching algorithm for go (library)
golang-github-mcuadros-go-gin-prometheus-dev - Gin Web Framework Prometheus metrics exporter
golang-github-mcuadros-go-lookup-dev - Small library on top of reflect for make lookups to any Structs or Maps
golang-github-mcuadros-go-version-dev - version normalizer and comparison library for Go
golang-github-mdlayher-arp-dev - Go module for the ARP protocol
golang-github-mdlayher-ethernet-dev - Marshaling and unmarshaling of Ethernet frames and VLAN tags
golang-github-mdlayher-genetlink-dev - generic netlink interactions and data types (library)
golang-github-mdlayher-netlink-dev - low-level access to Linux netlink sockets (library)
golang-github-mdlayher-netx-dev - Collection of small Go networking packages (library)
golang-github-mdlayher-raw-dev - Read and write data at the raw network interface device level
golang-github-mdlayher-socket-dev - low-level network connection type to provide asynchronous I/O (library)
golang-github-mdlayher-vsock-dev - Vsock provides access to Linux VM sockets (AF_VSOCK)
golang-github-mdlayher-wifi-dev - access to IEEE 802.11 Wi-Fi device actions and statistics (library)
golang-github-mendersoftware-go-lib-micro-dev - Group of golang packages for developing microservices. (library)
golang-github-mendersoftware-mender-artifact-dev - Library for managing Mender artifact files
golang-github-mendersoftware-openssl-dev - OpenSSL bindings for Go.
golang-github-mendersoftware-progressbar-dev - Minimal progressbar used in Mender projects (library)
golang-github-meowgorithm-babyenv-dev - Go environment var parsing
golang-github-meowgorithm-babylogger-dev - Go HTTP logger middleware
golang-github-mesos-mesos-go-dev - Go language bindings for Apache Mesos
golang-github-mgutz-ansi-dev - Small, fast library to create ANSI colored strings and codes
golang-github-mgutz-str-dev - comprehensive set of string functions
golang-github-mgutz-to-dev - Convenient type conversion utilities for Go
golang-github-mhilton-openid-dev - openid OP endpoint implementation (library)
golang-github-mholt-acmez-dev - Premier ACME client library for Go (library)
golang-github-michaeltjones-walk-dev - Fast parallel version of golang filepath.Walk()
golang-github-microcosm-cc-bluemonday-dev - Go library for scrubbing user generated data of unapproved html
golang-github-micromdm-scep-dev - SCEP go library
golang-github-miekg-dns-dev - DNS protocol library for Go
golang-github-miekg-mmark-dev - Markdown processor in Go geared for the IETF (Go library)
golang-github-miekg-pkcs11-dev - pkcs11 wrapper for Go
golang-github-mikesmitty-edkey-dev - generates ED25519 private keys in the OpenSSH private key format (Go library)
golang-github-minio-blake2b-simd-dev - Fast hashing using pure Go implementation of BLAKE2b with SIMD instructions
golang-github-minio-dsync-dev - Distributed sync package for Go
golang-github-minio-md5-simd-dev - SIMD accelerated MD5 package
golang-github-minio-minio-go-dev - Go library for Amazon S3 compatible cloud storage
golang-github-minio-minio-go-v7-dev - Go library for Amazon S3 compatible cloud storage
golang-github-minio-sha256-simd-dev - implementation of SHA256 using SIMD instructions for Intel and ARM
golang-github-miolini-datacounter-dev - Golang counters for readers/writers (library)
golang-github-miscreant-miscreant.go-dev - misuse-resistant encryption library
golang-github-mitch000001-go-hbci-dev - client library to use the HBCI standard
golang-github-mitchellh-cli-dev - library for implementing command-line interfaces
golang-github-mitchellh-colorstring-dev - Golang library for colorizing strings for terminal output
golang-github-mitchellh-copystructure-dev - library for deep copying values in Go
golang-github-mitchellh-go-fs-dev - Filesystem library for Go, implementing FAT filesystems so far
golang-github-mitchellh-go-homedir-dev - Go library for detecting and expanding the user's home directory
golang-github-mitchellh-go-linereader-dev - read lines from an io.Reader and puts them onto a channel
golang-github-mitchellh-go-ps-dev - Find, list, and inspect processes from Go (golang)
golang-github-mitchellh-go-testing-interface-dev - library to expose *testing.T as an interface
golang-github-mitchellh-go-vnc-dev - VNC client and server library for Go
golang-github-mitchellh-go-wordwrap-dev - Go package for wrapping words into multiple lines
golang-github-mitchellh-hashstructure-dev - generate hash values for arbitrary values in Golang
golang-github-mitchellh-iochan-dev - Go library for turning `io.Reader` into channels
golang-github-mitchellh-mapstructure-dev - library for decoding generic map values into native Go structures
golang-github-mitchellh-multistep-dev - library for building up complex actions using discrete steps
golang-github-mitchellh-panicwrap-dev - library for catching and handling panics in Go applications
golang-github-mitchellh-prefixedio-dev - library that demultiplexes line-oriented data from an io.Reader
golang-github-mitchellh-reflectwalk-dev - library for "walking" complex structures, similar to walking a filesystem
golang-github-mkrautz-goar-dev - library for reading and writing ar archives in Go
golang-github-mmcdole-gofeed-dev - Parse RSS and Atom feeds in Go (library)
golang-github-mmcdole-goxpp-dev - Go XML Pull Parser
golang-github-mmcloughlin-avo-dev - Generate x86 Assembly with Go (library)
golang-github-mna-redisc-dev - redis cluster client
golang-github-moby-locker-dev - Go library for creating finer-grained locking
golang-github-moby-sys-dev - Library to parse mount info and mount filesystems
golang-github-moby-term-dev - utilities for dealing with terminals
golang-github-modern-go-concurrent-dev - Modern-go concurrency utilities
golang-github-modern-go-reflect2-dev - Reflection API without runtime reflect.Value cost
golang-github-mohae-deepcopy-dev - create deep copies of things
golang-github-montanaflynn-stats-dev - Statistics package for Go
golang-github-morikuni-aec-dev - Golang wrapper for ANSI escape code
golang-github-moul-http2curl-dev - Go package for convert Golang's http.Request to CURL command line
golang-github-mozillazg-go-httpheader-dev - Go library for encoding structs into header fields
golang-github-mozillazg-go-pinyin-dev - Chinese pinyin conversion library for Golang.
golang-github-mozqnet-go-exploitdb-dev - builds a local copy of the Exploit-DB (OffensiveSecurity) (source)
golang-github-mreiferson-go-httpclient-dev - Go HTTP client with timeouts
golang-github-mreiferson-go-snappystream-dev - Go package for framed snappy streams
golang-github-mrjones-oauth-dev - OAuth 1.0 Library for Go
golang-github-mrunalp-fileutils-dev - collection of utilities for file manipulation in golang
golang-github-mssola-user-agent-dev - HTTP User Agent parser for Golang
golang-github-msteinert-pam-dev - Go wrapper module for the PAM API
golang-github-muesli-ansi-dev - raw ANSI sequence helpers for Go
golang-github-muesli-crunchy-dev - finds common flaws in passwords
golang-github-muesli-gitcha-dev - Go helpers to work with git repositories
golang-github-muesli-go-app-paths-dev - retrieve platform-specific paths (app-data, cache, config, etc.)
golang-github-muesli-goprogressbar-dev - Print progress bars on the console with Go
golang-github-muesli-reflow-dev - collection of (ANSI-sequence aware) text reflow operations & algorithms
golang-github-muesli-sasquatch-dev - simple data encryption library for Go
golang-github-muesli-smartcrop-dev - smartcrop finds good image crops for arbitrary crop sizes
golang-github-muesli-termenv-dev - Advanced ANSI style & color support for your terminal applications
golang-github-muesli-toktok-dev - typo/error resilient, human-readable token generator (Go library)
golang-github-muhammadmuzzammil1998-jsonc-dev - JSON with comments for Go!
golang-github-munnerz-goautoneg-dev - golang functions for HTTP Content-Type autonegotiation (library)
golang-github-mvdan-fdroidcl-dev - fdroidcl develpoment files
golang-github-mvdan-xurls-dev - extract urls from text
golang-github-mvo5-goconfigparser-dev - Python compatible INI parser
golang-github-mvo5-uboot-go-dev - Read/write uboot environment
golang-github-mwitkow-go-conntrack-dev - Go middleware for net.Conn tracking
golang-github-mxk-go-flowrate-dev - Go package for limiting and monitoring data flow rate
golang-github-namsral-flag-dev - Parse flags, environment variables and config files
golang-github-naoina-go-stringutil-dev - Faster string utilities implementation for Go
golang-github-naoina-toml-dev - TOML parser and encoder library for Golang
golang-github-nats-io-go-nats-dev - Golang client for NATS, the cloud native messaging system
golang-github-nats-io-jwt-dev - JWT tokens signed using NKeys for the NATS ecosystem
golang-github-nats-io-nkeys-dev - public-key signature system based on Ed25519
golang-github-nats-io-nuid-dev - NATS Unique Identifiers
golang-github-nbio-st-dev - Simple Test micro-framework for Go
golang-github-nbutton23-zxcvbn-go-dev - Strong password generator in Go
golang-github-ncabatoff-go-seq-dev - sequence go values to allow sorting them (library)
golang-github-ncw-go-acd-dev - Go library for accessing Amazon Cloud Drive
golang-github-ncw-swift-dev - Go language interface to Swift / Openstack / Rackspace cloud files
golang-github-nebulouslabs-bolt-dev - low-level key/value database for Go
golang-github-nebulouslabs-demotemutex-dev - Allow an RWMutex writelock to be demoted to a readlock.
golang-github-nebulouslabs-ed25519-dev - Go implementation of the Ed25519 signature algorithm
golang-github-nebulouslabs-entropy-mnemonics-dev - Human readable entropy.
golang-github-nebulouslabs-errors-dev - errors with context, composition, and easy error checking
golang-github-nebulouslabs-fastrand-dev - 10x faster than crypto/rand
golang-github-nebulouslabs-go-upnp-dev - Opinionated interface to Internet Gateway Devices
golang-github-nebulouslabs-merkletree-dev - Go package for working with Merkle trees
golang-github-neelance-astrewrite-dev - Go tool to walk & rewrite AST
golang-github-neelance-sourcemap-dev - Javascript source map reader and writer for Go
golang-github-neowaylabs-wabbit-dev - Golang AMQP mocking library
golang-github-nesv-go-dynect-dev - Go client library for Dyn's DynECT API
golang-github-netflix-go-expect-dev - expect-like golang library to automate terminal/console interactions
golang-github-newrelic-go-agent-dev - library for monitoring go applications
golang-github-nf-cr2-dev - basic Camera Raw 2 reader
golang-github-nfnt-resize-dev - Pure golang image resizing
golang-github-ngaut-deadline-dev - deadline reader/writer
golang-github-ngaut-go-zookeeper-dev - Native ZooKeeper client for Go
golang-github-ngaut-log-dev - Provides a simple log wrapper for ngaut libraries
golang-github-ngaut-pools-dev - provides pools for resources
golang-github-ngaut-sync2-dev - Additional synchronization primitives extracted from Vitess
golang-github-nginxinc-nginx-plus-go-client-dev - client for NGINX Plus API for Go (library)
golang-github-nicksnyder-go-i18n.v2-dev - Translate Go program into multiple languages
golang-github-nightlyone-lockfile-dev - Golang library to handle locking via pid files
golang-github-niklasfasching-go-org-dev - Org mode parser with HTML & pretty-printed Org rendering (Go library)
golang-github-nkovacs-streamquote-dev - Go package providing a streaming version of strconv.Quote
golang-github-nlopes-slack-dev - Go library for Slack API
golang-github-nozzle-throttler-dev - Fill the gap between WaitGroup and manually monitor goroutines with channels
golang-github-nrdcg-desec-dev - Go library for accessing the deSEC API
golang-github-nrdcg-goinwx-dev - INWX Go API client
golang-github-nsf-termbox-go-dev - pure Go implementation of termbox library
golang-github-nu7hatch-gouuid-dev - pure Go UUID implementation as specified in RFC 4122
golang-github-nwidger-jsoncolor-dev - Produce colorized json output for Go
golang-github-nxadm-tail-dev - Go package for reading from continuously updated files
golang-github-nytimes-gziphandler-dev - Golang middleware to gzip HTTP responses
golang-github-odeke-em-cache-dev - Simple cache with expirable values
golang-github-odeke-em-cli-spinner-dev - Simple spinner library for commandline
golang-github-odeke-em-command-dev - cli subcommands for Go
golang-github-odeke-em-ripper-dev - scrape licenses out of files -- library
golang-github-ogier-pflag-dev - POSIX/GNU-style command-line flags for Go
golang-github-oklog-run-dev - Universal mechanism to manage goroutine lifecycles
golang-github-oklog-ulid-dev - ULID generation library for Golang
golang-github-okzk-sdnotify-dev - systemd's service notification protocol (sd_notify)
golang-github-oleiade-reflections-dev - high level abstractions over Golang reflect library
golang-github-olekukonko-tablewriter-dev - generate ASCII tables in Golang
golang-github-olekukonko-ts-dev - Simple go library to get Terminal Size
golang-github-oneofone-xxhash-dev - native implementation of the excellent XXHash hashing algorithm
golang-github-onsi-ginkgo-dev - BDD Testing Framework for Go (development files)
golang-github-op-go-logging-dev - Golang logging library
golang-github-opencontainers-go-digest-dev - Common digest package used across the container ecosystem
golang-github-opencontainers-image-spec-dev - Open Container Initiative (OCI) Image Format Specification
golang-github-opencontainers-runc-dev - Open Container Project - development files
golang-github-opencontainers-runtime-tools-dev - OCI Runtime Tools
golang-github-opencontainers-selinux-dev - common selinux implementation
golang-github-opencontainers-specs-dev - Open Container Specifications
golang-github-opennota-urlesc-dev - Proper URL escaping as per RFC3986 for Go
golang-github-openpeedeep-xdg-dev - Cross platform package that follows the XDG Standard
golang-github-openprinting-goipp-dev - IPP core protocol in pure Go Library (RFC 8010)
golang-github-openshift-api-dev - OpenShift API definitions
golang-github-openshift-imagebuilder-dev - Builds container images using Dockerfile as input
golang-github-opensuse-umoci-dev - umoci development files
golang-github-opentracing-basictracer-go-dev - basic implementation of the OpenTracing API for Go
golang-github-opentracing-contrib-go-grpc-dev - OpenTracing support for gRPC client or server
golang-github-opentracing-contrib-go-stdlib-dev - OpenTracing instrumentation for packages in the Go stdlib
golang-github-opentracing-opentracing-go-dev - Go platform API for OpenTracing
golang-github-openzipkin-zipkin-go-dev - Zipkin tracer library for go
golang-github-optiopay-kafka-dev - Go client library for Apache Kafka
golang-github-oschwald-geoip2-golang-dev - Unofficial MaxMind GeoIP2 Reader for Go
golang-github-oschwald-maxminddb-golang-dev - MaxMind DB Reader for Go
golang-github-osrg-gobgp-dev - BGP implemented in Go (source)
golang-github-ostreedev-ostree-go-dev - Golang bindings for httt://github.com/ostreedev/ostree
golang-github-otiai10-copy-dev - Golang copy directory recursively (library)
golang-github-ovh-go-ovh-dev - Simple go wrapper for the OVH API
golang-github-oxtoacart-bpool-dev - Buffer/Byte pool for Go
golang-github-packer-community-winrmcp-dev - copy files to remote hosts using WinRM (Go library)
golang-github-packethost-packngo-dev - Golang API client library for Packet (cloud provider)
golang-github-parnurzeal-gorequest-dev - Go library for simplified HTTP client
golang-github-pascaldekloe-goe-dev - enterprise tooling library for Golang
golang-github-patrickmn-go-cache-dev - in-memory key:value store/cache (similar to Memcached)
golang-github-paulbellamy-ratecounter-dev - thread-safe RateCounter implementation in Golang
golang-github-paulrosania-go-charset-dev - character set conversion for Go
golang-github-paypal-gatt-dev - building Bluetooth Low Energy peripherals
golang-github-pbnjay-memory-dev - Provides go function to report total system memory
golang-github-pborman-getopt-dev - getopt style option parsing for Go (library)
golang-github-pborman-uuid-dev - Go bindings to work with UUIDs
golang-github-pd0mz-go-maidenhead-dev - Maidenhead Locator system in Golang (library)
golang-github-pearkes-cloudflare-dev - Cloudflare library written in Go
golang-github-pearkes-dnsimple-dev - DNSimple library written in Go
golang-github-pelletier-go-buffruneio-dev - wrapper around bufio to provide buffered runes access
golang-github-pelletier-go-toml - Go library for the TOML format ?? command-line programs
golang-github-pelletier-go-toml-dev - Go library for the TOML format
golang-github-pelletier-go-toml.v2-dev - Go library for the TOML format (go-toml v2)
golang-github-petar-gollrb-dev - LLRB implementation of balanced binary search trees for Go
golang-github-peterbourgon-diskv-dev - disk-backed key-value store
golang-github-peterh-liner-dev - Command line editor with history
golang-github-peterhellberg-link-dev - Go package for parsing link headers
golang-github-petermattis-goid-dev - programmatically retrieve the current goroutine's ID
golang-github-philhofer-fwd-dev - Buffered Reader/Writer
golang-github-phpdave11-gofpdi-dev - Go Free PDF Document Importer
golang-github-pierrec-lz4-dev - LZ4 compression and decompression in pure Go
golang-github-pierrec-xxhash-dev - pure Go implementation of xxHash (32 and 64 bits versions)
golang-github-pin-tftp-dev - TFTP server and client library for Golang (library)
golang-github-pingcap-check-dev - rich testing extension for Go's testing package
golang-github-pires-go-proxyproto-dev - golang library of PROXY protocol for v1 and v2
golang-github-pivotal-golang-clock-dev - Time provider and clock testing library for Go
golang-github-pkg-diff-dev - go library used to create, modify, and print diffs
golang-github-pkg-errors-dev - Simple error handling primitives for Go
golang-github-pkg-profile-dev - Simple profiling for Go
golang-github-pkg-sftp-dev - SFTP support for the golang.org/x/crypto/ssh package
golang-github-pkg-term-dev - package term manages POSIX terminals
golang-github-pkg-xattr-dev - Extended attribute support for Go
golang-github-pmezard-go-difflib-dev - partial port of Python difflib package to Go
golang-github-pmylund-go-cache-dev - Go library for in-memory key/value store similar to memcached
golang-github-pointlander-compress-dev - parallelized modular compression library
golang-github-pointlander-jetset-dev - JetSet is a compressed set of numbers
golang-github-pointlander-peg-dev - implementation of a Packrat parser generator - dev package
golang-github-posener-complete-dev - bash completion written in go
golang-github-powerman-check-dev - Helpers to complement Go testing package
golang-github-powerman-deepequal-dev - Go library with improved reflect.DeepEqual
golang-github-pquerna-cachecontrol-dev - HTTP Cache-Control Parser and Interpretation
golang-github-pquerna-ffjson-dev - faster JSON serialization for Go
golang-github-pquerna-otp-dev - Google Authenticator compatible one time passwords for Go
golang-github-proglottis-gpgme-dev - Go wrapper for the GPGME library
golang-github-prometheus-alertmanager-dev - handle and deliver alerts created by Prometheus -- source
golang-github-prometheus-client-golang-dev - Prometheus instrumentation library for Go applications
golang-github-prometheus-client-model-dev - data model artifacts for Prometheus
golang-github-prometheus-common-dev - common libraries for Prometheus components
golang-github-prometheus-exporter-toolkit-dev - Go library for Prometheus exporters
golang-github-prometheus-procfs-dev - Golang library to retrieve metrics from the proc pseudo-filesystem
golang-github-prometheus-prom2json-dev - tool to scrape a Prometheus client and dump the result as JSON (library)
golang-github-protonmail-go-autostart-dev - Go library to run a command after login
golang-github-protonmail-go-crypto-dev - Go supplementary cryptography libraries
golang-github-puerkitobio-goquery-dev - jQuery-style HTML manipulation in Go
golang-github-puerkitobio-purell-dev - tiny Go library to normalize URLs
golang-github-putdotio-go-putio-dev - Put.io Go API client
golang-github-pzhin-go-sophia-dev - Golang binding for the Sophia database
golang-github-qor-inflection-dev - Pluralizes and singularizes English nouns
golang-github-quobyte-api-dev - Quobyte API client for Go
golang-github-racksec-srslog-dev - replacement for the standard Golang library "log/syslog"
golang-github-rafaeljusto-redigomock-dev - Unit tests using redigo library (Redis client in go)
golang-github-raintank-met-dev - wrapper around metric client libraries for Go
golang-github-rainycape-unidecode-dev - replace non-ASCII characters with their ASCII approximations
golang-github-rakyll-globalconf-dev - Effortlessly persist/retrieve flags in Go programs
golang-github-rakyll-statik-dev - embed static files into a Go executable. Dev package
golang-github-rancher-go-rancher-metadata-dev - Go Bindings for Rancher-metadata service (library)
golang-github-rclone-rclone-dev - go source code of rclone
golang-github-rcrowley-go-metrics-dev - Application level metrics capturing library for Go
golang-github-remeh-sizedwaitgroup-dev - Go library for limiting the amount of concurrent goroutines
golang-github-remyoudompheng-bigfft-dev - Golang big integer multiplication library
golang-github-remyoudompheng-go-liblzma-dev - Go bindings for XZ Utils/liblzma
golang-github-renekroon-ttlcache-dev - In-memory string-interface{} map with expiration for Golang
golang-github-renstrom-dedent-dev - Transitional package for golang-github-lithammer-dedent-dev
golang-github-restic-chunker-dev - implementation of Content Defined Chunking (CDC) in Go
golang-github-retailnext-hllpp-dev - HyperLogLog++ cardinality estimation algorithm
golang-github-revel-revel-dev - high productivity, full-stack web framework for the Go language
golang-github-reviewdog-errorformat-dev - Vim's quickfix errorformat implementation in Go (library)
golang-github-rfjakob-eme-dev - EME wide-block encryption for Go
golang-github-rhnvrm-simples3-dev - AWS S3 Golang Library
golang-github-rican7-retry-dev - Go library to perform actions repetitively
golang-github-rickb777-date-dev - Go package for working with dates (library)
golang-github-rickb777-plural-dev - Simple Go API for pluralisation. (library)
golang-github-rifflock-lfshook-dev - local filesystem hook for logrus (Go library)
golang-github-rivo-tview-dev - Rich interactive widgets for terminal-based UIs in Go
golang-github-rivo-uniseg-dev - Unicode Text Segmentation for Go
golang-github-riywo-loginshell-dev - Golang library to get the login shell of the current user
golang-github-rjeczalik-notify-dev - file system event notification library on steroids
golang-github-rkoesters-xdg-dev - FreeDesktop.org (xdg) Specs implemented in Go
golang-github-roaringbitmap-roaring-dev - Roaring bitmaps in Go
golang-github-robertkrimen-otto-dev - JavaScript parser and interpreter in Go
golang-github-robfig-config-dev - Configuration file parser for INI format
golang-github-robfig-cron-dev - cron library for go
golang-github-robfig-go-cache-dev - in-memory key:value store/cache library for Go
golang-github-robfig-pathtree-dev - Go library for fast lookups using trees
golang-github-rogpeppe-fastuuid-dev - fast generation of 192-bit UUIDs
golang-github-rogpeppe-go-internal-dev - Selected Go-internal packages factored out from the standard library
golang-github-rootless-containers-proto-dev - Protobuf descriptions for rootless containers purposes
golang-github-rootless-containers-rootlesskit-dev - Linux-native "fake root" for rootless containers (library)
golang-github-rs-cors-dev - net/http configurable handler to handle CORS requests
golang-github-rs-xid-dev - globally unique id generator thought for the web
golang-github-rs-zerolog-dev - Zero Allocation JSON Logger
golang-github-rsc-devweb - Development web server
golang-github-rubenv-sql-migrate-dev - SQL schema migration tool for Go (library)
golang-github-rubyist-tracerx-dev - Output tracing information in your Go app based on environment variables
golang-github-russellhaering-goxmldsig-dev - Pure Go implementation of XML Digital Signatures
golang-github-russross-blackfriday-dev - Blackfriday: a markdown processor for Go
golang-github-russross-blackfriday-v2-dev - Blackfriday: a markdown processor for Go version 2
golang-github-ruudk-golang-pdf417-dev - PDF417 barcodes in Golang
golang-github-rwcarlsen-goexif-dev - Decode embedded EXIF meta data from image files with Go
golang-github-ryanuber-columnize-dev - Easy column formatted output for golang
golang-github-ryanuber-go-glob-dev - Basic string globs in golang
golang-github-ryszard-goskiplist-dev - A skip list implementation in Go
golang-github-sabhiram-go-gitignore-dev - gitignore parser for go
golang-github-safchain-ethtool-dev - simple ethtool-like library for Go
golang-github-sahilm-fuzzy-dev - Go library for fuzzy string matching
golang-github-samalba-dockerclient-dev - Docker client library in Go
golang-github-samuel-go-zookeeper-dev - native ZooKeeper client for Go
golang-github-sanity-io-litter-dev - Pretty printer library for Go data structures to aid in debugging and testing
golang-github-sap-go-hdb-dev - SAP HANA Database Client for Go
golang-github-saracen-walker-dev - walker is a faster, parallel version, of filepath.Walk
golang-github-sasha-s-go-deadlock-dev - Online deadlock detection in go
golang-github-satori-go.uuid-dev - Go package for creating and parsing UUID
golang-github-satta-ifplugo-dev - network link status notification for Go
golang-github-schollz-closestmatch-dev - Golang library for fuzzy matching within a set of strings
golang-github-schollz-progressbar-dev - thread-safe progress bar for Golang applications
golang-github-scylladb-termtables-dev - Fast and simple ASCII table generation.
golang-github-sean--pager-dev - pager support for Go
golang-github-sean--seed-dev - securely seed Go's random number generator
golang-github-seandolphin-bqschema-dev - Go library to process Google Big Query
golang-github-sebdah-goldie-dev - Golden file testing for Go (library)
golang-github-sebest-xff - Golang Middleware to handle X-Forwarded-For Header
golang-github-sebest-xff-dev - Golang Middleware to handle X-Forwarded-For Header (development files)
golang-github-seccomp-containers-golang-dev - libseccomp mappings in Golang
golang-github-seccomp-libseccomp-golang-dev - golang bindings for libseccomp
golang-github-segmentio-fasthash-dev - Fast, efficient hashing algorithms library
golang-github-segmentio-kafka-go-dev - Kafka library in Go
golang-github-segmentio-ksuid-dev - K-Sortable Globally Unique IDs (Go library)
golang-github-seiflotfy-cuckoofilter-dev - Bloom filter replacement using cuckoo hashing
golang-github-serenize-snaker-dev - Convert camel cased strings to snake case and back
golang-github-sergi-go-diff-dev - Diff, match and patch text in Go
golang-github-sethvargo-go-fastly-dev - Fastly API client library
golang-github-sevlyar-go-daemon-dev - library for writing system daemons
golang-github-shenwei356-bio-dev - lightweight and high-performance bioinformatics package in Golang (library)
golang-github-shenwei356-bpool-dev - Buffer/Byte pool for Go (library)
golang-github-shenwei356-breader-dev - buffered file reader library for Go
golang-github-shenwei356-bwt-dev - Burrows-Wheeler Transform and FM-index in golang (library)
golang-github-shenwei356-natsort-dev - natural strings sorting in Go (library)
golang-github-shenwei356-util-dev - Golang utility packages (library)
golang-github-shenwei356-xopen-dev - open files for buffered reading and writing in Go (library)
golang-github-shibukawa-configdir-dev - multi platform library of configuration directories for Golang
golang-github-shiena-ansicolor-dev - Ansicolor library for Golang
golang-github-shirou-gopsutil-dev - Go package implementing psutils
golang-github-shogo82148-go-shuffle-dev - Primitives for shuffling slices and user-defined collections in Go
golang-github-shopify-logrus-bugsnag-dev - logrus-bugsnag is a hook that interfaces Logrus with Bugsnag
golang-github-shopify-sarama-dev - Go library for Apache Kafka
golang-github-shopspring-decimal-dev - arbitrary-precision fixed-point decimal numbers in go
golang-github-showmax-go-fqdn-dev - Golang library to provide local machine FQDN
golang-github-shurcool-githubv4-dev - Go client library for accessing GitHub GraphQL API v4
golang-github-shurcool-gopherjslib-dev - library that provides helpers for in-process GopherJS compilation
golang-github-shurcool-graphql-dev - GraphQL client implementation (Go library)
golang-github-shurcool-httpfs-dev - Go library for working with the http.FileSystem interface
golang-github-shurcool-httpgzip-dev - go library for use gzip compression when serving HTTP requests
golang-github-shurcool-sanitized-anchor-name-dev - Go package for creating sanitized anchor names
golang-github-siddontang-go-dev - Collection of siddontang libraries for Go
golang-github-siddontang-go-snappy-dev - Snappy compression format in Go
golang-github-siddontang-goredis-dev - Redis client implementation in Go
golang-github-siddontang-rdb-dev - Read Redis rdb files in Go
golang-github-sirupsen-logrus-dev - Logrus: a logging library for Go
golang-github-sjoerdsimons-ostree-go-dev - Golang bindings for OSTree
golang-github-skarademir-naturalsort-dev - simple natural sorter for Go Strings
golang-github-skeema-mybase-dev - CLI framework with MySQL-like option handling (library)
golang-github-skip2-go-qrcode-dev - QR Code encoder (Go library)
golang-github-skratchdot-open-golang-dev - library to open an URI in the user's preferred application
golang-github-smallfish-simpleyaml-dev - Go package to interact with arbitrary YAML
golang-github-smallstep-assert-dev - simple assertion framework written in go
golang-github-smallstep-cli-dev - go library for working with x509 certificates
golang-github-smallstep-nosql-dev - abstraction layer for data persistency written in golang
golang-github-smallstep-truststore-dev - Go library for local installation of development certificates
golang-github-smartystreets-assertions-dev - fluent assertion-style functions
golang-github-smartystreets-go-aws-auth-dev - Go library to signs requests to Amazon Web Services
golang-github-smartystreets-goconvey-dev - Go testing in browser - sources
golang-github-smartystreets-gunit-dev - xUnit-style test fixture adapter for go test
golang-github-smira-commander-dev - library to provide command-line commands and sub-commands
golang-github-smira-flag-dev - flag with a Get() interface{} method
golang-github-smira-go-aws-auth-dev - signs requests to Amazon Web Services
golang-github-smira-go-ftp-protocol-dev - plugin for http.Transport with support for ftp:// protocol
golang-github-smira-go-xz-dev - simple .xz decompression using external program (xz --decompress)
golang-github-snapcore-snapd-dev - snappy development go packages.
golang-github-socketplane-libovsdb-dev - OVSDB client library written in Go
golang-github-soheilhy-cmux-dev - serve different services on the same port
golang-github-soniah-dnsmadeeasy-dev - DNSMadeEasy library written in Go
golang-github-soniah-gosnmp-dev - Transitional dummy package
golang-github-soundcloud-go-runit-dev - Go library wrapping runit service status
golang-github-sourcegraph-jsonrpc2-dev - client and server implementation of JSON-RPC 2.0 (library)
golang-github-spacejam-loghisto-dev - counters and logarithmically bucketed histograms for distributed systems
golang-github-spaolacci-murmur3-dev - Native MurmurHash3 Go implementation
golang-github-spf13-afero-dev - FileSystem Abstraction System for Go
golang-github-spf13-cast-dev - Safe and easy casting from one type to another in Go
golang-github-spf13-cobra-dev - Go library for creating powerful modern Go CLI applications
golang-github-spf13-fsync-dev - Keeps files or directories in sync for Go
golang-github-spf13-jwalterweatherman-dev - Go library for both printing to the terminal and logging to files
golang-github-spf13-nitro-dev - Quick and easy performance analyzer library for Go
golang-github-spf13-pflag-dev - Drop-in replacement for Go's flag package, implementing POSIX/GNU-style --flags
golang-github-spf13-viper-dev - Go configuration with fangs
golang-github-spkg-bom-dev - Strip UTF-8 byte order marks
golang-github-src-d-gcfg-dev - reads INI-style configuration files into Go structs
golang-github-ssgelm-cookiejarparser-dev - Go library that parses a curl cookiejar file into a Go http.CookieJar
golang-github-ssor-bom-dev - small Go library to clean bom from byte array or reader
golang-github-stacktic-dropbox-dev - Go client library for the Dropbox core and Datastore API
golang-github-stathat-go-dev - Go package for reporting stat counts and values to StatHat
golang-github-steveyen-gtreap-dev - gtreap is an immutable treap implementation in the Go Language
golang-github-stevvooe-resumable-dev - Subset of the Go `crypto` Package with a Resumable Hash Interface
golang-github-stoewer-go-strcase-dev - go library for converting between naming formats
golang-github-streadway-amqp-dev - Go client for AMQP 0.9.1
golang-github-stretchr-objx-dev - Go package for dealing with maps, slices, JSON and other data
golang-github-stretchr-testify-dev - sacred extension to the standard Go testing package
golang-github-stvp-go-udp-testing-dev - UDP test helpers for Go
golang-github-stvp-roll-dev - Simple(er) Rollbar client for Go
golang-github-stvp-tempredis-dev - Go package to start and stop temporary redis-server processes
golang-github-suapapa-go-eddystone-dev - golang library for supporting Eddystone
golang-github-subosito-gotenv-dev - Load environment variables from `.env` or `io.Reader` in Go.
golang-github-surma-gocpio-dev - Go package for cpio archives
golang-github-svanharmelen-jsonapi-dev - jsonapi.org style payload serializer and deserializer
golang-github-svent-go-flags-dev - go library for parsing command line arguments
golang-github-svent-go-nbreader-dev - non-blocking io.Reader for go
golang-github-sylabs-json-resp-dev - marshall and unmarshall response data and errors in JSON format
golang-github-sylabs-sif-dev - reference implementation of the Singularity Image Format (SIF)
golang-github-syncthing-notify-dev - File system event notification library on steroids
golang-github-syncthing-syncthing-dev - decentralized file synchronization - dev package
golang-github-syndtr-goleveldb-dev - LevelDB key/value database in Go
golang-github-tarm-serial-dev - Go package for serial port communucation
golang-github-tatsushid-go-prettytable-dev - Builds a simple text table with a multibyte, doublewidth character support
golang-github-tchap-go-patricia-dev - golang-go-patricia is a generic patricia trie (also called radix tree).
golang-github-tcnksm-go-gitconfig-dev - Golang library for gitconfig values
golang-github-tdewolff-minify-dev - Go minifiers for web formats
golang-github-tdewolff-parse-dev - Go parsers for web formats
golang-github-tdewolff-test-dev - Go test helper functions
golang-github-tealeg-xlsx-dev - golang library for reading and writing XLSX files
golang-github-teambition-rrule-go-dev - Go library for working with recurrence rules for calendar dates. (library)
golang-github-templexxx-cpufeat-dev - internal/cpu in Go
golang-github-templexxx-reedsolomon-dev - Reed-Solomon Erasure Code engine in Go
golang-github-templexxx-xor-dev - XOR in Go, more than 10GB/s per core
golang-github-tent-canonical-json-go-dev - Canonical JSON marshaling in Go
golang-github-tent-http-link-go-dev - HTTP Link parsing in Go
golang-github-teris-io-shortid-dev - auper short, fully unique, non-sequential and URL friendly Ids
golang-github-terra-farm-udnssdk-dev - ultradns SDK
golang-github-tevino-abool-dev - Atomic Boolean library, optimized for performance yet simple to use
golang-github-thales-e-security-pool-dev - Collection of go packages from Vitess (library)
golang-github-thalesignite-crypto11-dev - implementation of Golang crypto interfaces with PKCS#11 as backend
golang-github-thcyron-uiprogress-dev - render progress bars in terminal applications
golang-github-thecreeper-go-notify-dev - implementation of the GNOME DBus Notifications Specification
golang-github-thedevsaddam-gojsonq-dev - Simple Go package to query over JSON data (library)
golang-github-thejerf-suture-dev - supervisor trees for Go
golang-github-thoj-go-ircevent-dev - Event based IRC Client library in Go
golang-github-thomasrooney-gexpect-dev - pure golang expect library
golang-github-thomsonreuterseikon-go-ntlm-dev - NTLM Implementation for Go
golang-github-throttled-throttled-dev - rate limiting access to resources such as HTTP endpoints
golang-github-tideland-golib-dev - collection of misc Go packages
golang-github-tidwall-btree-dev - B-Tree implementation for Go
golang-github-tidwall-buntdb-dev - embeddable, in-memory key/value database for Go
golang-github-tidwall-gjson-dev - JSON parser for Go
golang-github-tidwall-grect-dev - Get the outer rectangle from GeoJSON, WKT, WKB
golang-github-tidwall-match-dev - simple string pattern matcher for Go
golang-github-tidwall-pretty-dev - Efficient JSON beautifier and compactor for Go
golang-github-tidwall-rtree-dev - RTree implementation for Go
golang-github-tidwall-tinyqueue-dev - Binary heap priority queues in Go
golang-github-timberio-go-datemath-dev - Go library for parsing Elasticsearch datemath expressions
golang-github-tinylib-msgp-dev - Go code generator for MessagePack (source)
golang-github-tjfoc-gmsm-dev - GM SM2/3/4 library based for Golang
golang-github-tklauser-go-sysconf-dev - sysconf for Go, without using cgo (library)
golang-github-tklauser-numcpus-dev - Go module to get the number of CPUs (library)
golang-github-tmc-grpc-websocket-proxy-dev - proxy to upgrade grpc-gateway streaming endpoints to use websockets
golang-github-tmc-scp-dev - basic implementation of scp for go
golang-github-tobi-airbrake-go-dev - Go library to report exceptions and errors to the Airbrake service
golang-github-tombuildsstuff-giovanni-dev - alternative Azure Storage SDK for Go
golang-github-tomnomnom-linkheader-dev - HTTP Link header parser
golang-github-tonistiigi-fifo-dev - Go package for handling FIFOs in a sane way
golang-github-tonistiigi-fsutil-dev - Incremental file directory sync tools (library)
golang-github-tonistiigi-units-dev - Simple byte size formatting library
golang-github-toqueteos-webbrowser-dev - Convenient Web-browser controller library for Go
golang-github-traefik-yaegi-dev - Another Elegant Go Interpreter - dev package
golang-github-tsenart-tb-dev - generic lock-free implementation of the "Token-Bucket" algorithm
golang-github-ttacon-chalk-dev - Go library for prettifying terminal/console output
golang-github-tv42-httpunix-dev - library to talk HTTP over Unix domain sockets
golang-github-twinj-uuid-dev - RFC 4122 and DCE 1.1 compliant UUIDs in Go
golang-github-twmb-murmur3-dev - fast, fully fledged murmur3 in Go
golang-github-twotwotwo-sorts-dev - Parallel and radix sorting in Go
golang-github-twstrike-gotk3adapter-dev - adapters and interfaces for gotk3
golang-github-twstrike-otr3-dev - Go implementation of the OTR 3 protocol
golang-github-ua-parser-uap-go-dev - Go implementation of ua-parser
golang-github-uber-go-atomic-dev - Wrapper types for sync/atomic which enforce atomic access
golang-github-uber-go-tally-dev - Go metrics interface with fast metrics reporters (library)
golang-github-ubuntu-core-snappy-dev - transitional dummy package
golang-github-ugorji-go-codec - idiomatic codec and rpc lib for msgpack, cbor, json (codecgen)
golang-github-ugorji-go-codec-dev - idiomatic codec and rpc lib for msgpack, cbor, json (library)
golang-github-ugorji-go-msgpack-dev - encode/decode and rpc library for msgpack and Binc
golang-github-ulikunitz-xz-dev - Pure golang package for reading and writing xz-compressed files
golang-github-ulule-limiter-dev - Dead simple rate limit middleware for Go
golang-github-ungerik-go-sysfs-dev - Go package for Linux sysfs
golang-github-unknwon-com-dev - commonly used functions for Golang
golang-github-unknwon-goconfig-dev - configuration file (.ini) parser
golang-github-unknwon-i18n-dev - Internationalization and Localization in Go
golang-github-unknwon-paginater-dev - Helper module for custom pagination calculation
golang-github-unrolled-render-dev - Easily render JSON, XML, binary, or HTML templates responses (library)
golang-github-unrolled-secure-dev - HTTP middlewares for Go that facilitates security checks (library)
golang-github-urfave-cli-dev - package for building command line apps in Go
golang-github-urfave-cli-v2-dev - package for building command line apps in Go (version 2)
golang-github-urfave-negroni-dev - Idiomatic HTTP Middleware for Golang
golang-github-valyala-bytebufferpool-dev - Anti-memory-waste byte buffer pool for go
golang-github-valyala-fasthttp-dev - fast HTTP library for Go
golang-github-valyala-fastjson-dev - fast JSON parser and validator for Go (library)
golang-github-valyala-fastrand-dev - fast and scalable pseudorandom generator for Go (library)
golang-github-valyala-fasttemplate-dev - simple and fast template engine for Go
golang-github-valyala-gozstd-dev - go wrapper for zstd (library)
golang-github-valyala-histogram-dev - fast histograms for Go (library)
golang-github-valyala-quicktemplate-dev - fast, powerful, yet easy to use template engine for Go (lborary)
golang-github-valyala-tcplisten-dev - Customizable TCP net.Listener for Go (library)
golang-github-varlink-go-dev - Golang implementation of the Varlink protocol
golang-github-vaughan0-go-ini-dev - INI parsing library for Go
golang-github-vbatts-go-mtree-dev - file systems verification library, in likeness of mtree(8)
golang-github-vbatts-tar-split-dev - tar archive assembly/disassembly (source)
golang-github-vbauerster-mpb-dev - multi progress bar for Go cli applications
golang-github-viant-assertly-dev - Arbitraty datastructure validation golang library
golang-github-viant-toolbox-dev - Toolbox - golang utility library
golang-github-victoriametrics-fastcache-dev - fast thread-safe in-memory cache for big number of entries in Go (library)
golang-github-victoriametrics-metrics-dev - lightweight alternative to prometheus/client_golang (library)
golang-github-victoriametrics-metricsql-dev - standalone PromQL and MetricsQL parser (library)
golang-github-victoriametrics-victoriametrics-dev - fast, cost-effective and scalable time series database (library)
golang-github-viki-org-dnscache-dev - DNS cache for Go
golang-github-vimeo-go-magic-dev - Go bindings for libmagic
golang-github-vincent-petithory-dataurl-dev - Data URL Schemes in Golang (library)
golang-github-vishvananda-netlink-dev - netlink library for go
golang-github-vishvananda-netns-dev - network namespaces in go
golang-github-vitrun-qart-dev - generates not-so-ugly qr codes
golang-github-vividcortex-ewma-dev - Exponentially Weighted Moving Average algorithms for Go
golang-github-vividcortex-godaemon-dev - Daemonize Go applications deviously
golang-github-vividcortex-mysqlerr-dev - MySQL Server Error Constants
golang-github-vjeantet-grok-dev - simple library to use/parse grok patterns with Go
golang-github-vmihailenco-tagparser-dev - Golang tag parser
golang-github-vmware-govmomi-dev - Go library for the VMware vSphere API
golang-github-vmware-photon-controller-go-sdk-dev - VMware Photon Controller API library
golang-github-vmware-vmw-guestinfo-dev - access VMware guestinfo variables in Go (library)
golang-github-vmware-vmw-ovflib-dev - parse Open Virtualization Format (OVF) environment in Go (library)
golang-github-voxelbrain-goptions-dev - flexible Go parser for command line options
golang-github-vulcand-oxy-dev - Go middlewares for HTTP servers & proxies (library)
golang-github-vulcand-predicate-dev - Library for creating predicate mini-languages in Go
golang-github-vultr-govultr-dev - Vultr Go API client
golang-github-wader-gojq-dev - pure Go implementation of jq (library)
golang-github-wader-readline-dev - Readline is a pure go(golang) implementation for GNU-Readline like library
golang-github-weaveworks-mesh-dev - go library to build distributed systems
golang-github-wellington-go-libsass-dev - Go wrapper for libsass, the only Sass 3.5 compiler for Go
golang-github-weppos-dnsimple-go-dev - DNSimple API v1 client for Go
golang-github-weppos-publicsuffix-go-dev - Domain name parser on the Public Suffix List (library)
golang-github-wildducktheories-go-csv-dev - tools for manipulating CSV files
golang-github-will-rowe-nthash-dev - Go implementation of ntHash
golang-github-willf-bitset-dev - Implements bitsets, a mapping between non-negative integers and boolean values
golang-github-willf-bloom-dev - Go package implementing Bloom filters
golang-github-willfaught-gockle-dev - simpler and mockable gocql
golang-github-wsxiaoys-terminal-dev - Colorful terminal output for Golang
golang-github-x448-float16-dev - IEEE 754 half-precision format (library)
golang-github-x86kernel-htmlcolor-dev - HTML syntax highlighter for Go
golang-github-xanzy-go-cloudstack-dev - Golang API client to interact with Apache CloudStack
golang-github-xanzy-go-gitlab-dev - Simple and uniform GitLab API for Go
golang-github-xanzy-ssh-agent-dev - Go library for creating SSH agents
golang-github-xdg-go-pbkdf2-dev - PBKDF2 key generation (library)
golang-github-xdg-go-scram-dev - RFC-5802 SCRAM in Go (library)
golang-github-xdg-go-stringprep-dev - RFC-3454 stringprep and RFC-4013 SASLprep in Go (library)
golang-github-xeipuuv-gojsonpointer-dev - JSON Pointer implementation in Golang
golang-github-xeipuuv-gojsonreference-dev - JSON Reference implementation in Golang
golang-github-xeipuuv-gojsonschema-dev - implementation of JSON Schema, draft v4
golang-github-xenolf-lego-dev - Let's Encrypt ACME library
golang-github-xi2-xz-dev - native Go XZ decompression
golang-github-xiang90-probing-dev - Go library for HTTP probing
golang-github-xlab-handysort-dev - Alphanumeric string sorting algorithm implementation in Go
golang-github-xlab-treeprint-dev - simple ASCII tree composing tool
golang-github-xlzd-gotp-dev - Golang OTP (One-Time Password) Library
golang-github-xo-terminfo-dev - terminfo package in pure go
golang-github-xorcare-pointer-dev - for simplifying the creation of optional fields of basic type
golang-github-xordataexchange-crypt - Store/retrieve encrypted configs from etcd or Consul (CLI tool)
golang-github-xordataexchange-crypt-dev - Store/retrieve encrypted configs from etcd or Consul (Go library)
golang-github-xorpaul-uiprogress-dev - Go library to render progress bars in terminal applications
golang-github-xrash-smetrics-dev - String metrics library written in Go
golang-github-xtaci-kcp-dev - Full-Featured Reliable-UDP Library for golang
golang-github-xtaci-smux-dev - Simple Multiplexing for golang
golang-github-xtaci-tcpraw-dev - Packet-oriented connection golan library by simulating TCP
golang-github-xyproto-pinterface-dev - Interface types for simple* and permission* packages
golang-github-xyproto-simpleredis-dev - easy way to use Redis from Go
golang-github-yggdrasil-network-yggdrasil-go-dev - Fully encrypted global-scale mesh network (library)
golang-github-yl2chen-cidranger-dev - Fast IP to CIDR lookup in Golang
golang-github-ymomoi-goval-parser-dev - OVAL parser written in go
golang-github-yohcop-openid-go-dev - OpenID consumer implementation in Go (library)
golang-github-yosssi-ace-dev - HTML template engine for Go (library package)
golang-github-yosssi-ace-proxy-dev - Proxy for the Ace template engine (Go library)
golang-github-yosssi-gohtml-dev - HTML formatter for Go
golang-github-youmark-pkcs8-dev - Go package to parse and convert private keys in PKCS#8 format (library)
golang-github-youpy-go-riff-dev - Go library to read/write RIFF format
golang-github-youpy-go-wav-dev - Go library to read/write WAVE(RIFF waveform Audio) Format
golang-github-yourbasic-graph-dev - graph algorithms and data structures
golang-github-yudai-gojsondiff-dev - compare two JSON strings
golang-github-yudai-golcs-dev - Go Longest Common Subsequence
golang-github-yuin-gluare-dev - Regular expression library for the GopherLua
golang-github-yuin-goldmark-dev - CommonMark compliant and extensible Markdown parser written in Go
golang-github-yuin-goldmark-emoji-dev - emoji extension for the goldmark Markdown parser (Go library)
golang-github-yuin-goldmark-highlighting-dev - syntax highlighting extension for the goldmark Markdown parser
golang-github-yuin-gopher-lua-dev - virtual machine and compiler for Lua in Go
golang-github-yvasiyarov-newrelic-platform-go-dev - Newrelic Platform SDK for Go
golang-github-zaf-g711-dev - encode and decode ITU-T G.711 sound data
golang-github-zclconf-go-cty-debug-dev - debugging and inspection utilities for cty
golang-github-zclconf-go-cty-dev - type system for dynamic values in Golang applications
golang-github-zclconf-go-cty-yaml-dev - YAML marshalling and unmarshalling for go-cty
golang-github-zeebo-wyhash-dev - Go port of wyhash v3
golang-github-zenazn-goji-dev - minimalistic web framework for Golang
golang-github-zenhack-go.notmuch-dev - Go language bindings for notmuch mail (library)
golang-github-ziutek-mymysql-dev - MySQL Client API
golang-github-zmap-rc2-dev - RC2 Cipher in Golang
golang-github-zorkian-go-datadog-api-dev - Go implementation of the Datadog API
golang-github-zyedidia-clipboard-dev - clipboard for golang
golang-github-zyedidia-glob-dev - Go package for glob matching
golang-github-zyedidia-pty-dev - Go package for using Unix pseudo-terminals
golang-github-zyedidia-tcell-dev - Cell based view for text terminals
golang-github-zyedidia-terminal-dev - vt10x terminal emulation backend
golang-gitlab-gitlab-org-labkit-dev - LabKit provides functionality for Go services at GitLab
golang-gitlab-golang-commonmark-puny-dev - Functions for encoding/decoding to/from punycode (library)
golang-gitlab-lupine-go-mimedb-dev - Baked-in MIME types for standalone Go binaries
golang-gitlab-yawning-edwards25519-extra-dev - Extensions to the Go standard library's Ed25519 and curve25519 implementations (library)
golang-go-flags-dev - Transitional package for golang-github-jessevdk-go-flags-dev
golang-go-semver-dev - Transitional package for golang-github-coreos-go-semver-dev
golang-google-grpc-dev - implementation of gRPC in Go
golang-gopkg-check.v1-dev - Rich testing extension for Go's testing package
golang-gopkg-libgit2-git2go.v31-dev - Go bindings for libgit2
golang-gopkg-src-d-go-git.v4-dev - highly extensible Git implementation in pure Go
golang-mreiferson-httpclient-dev - Transitional package for golang-github-mreiferson-go-httpclient-dev
golang-snappy-go-dev - Transitional package for golang-github-golang-snappy-dev
golang-websocket-dev - Transitional package for golang-github-gorilla-websocket-dev
gphoto2 - digital camera command-line client
gphotofs - filesystem to mount digital cameras
gpscorrelate - correlates digital photos with GPS data filling EXIF fields (command line)
gpscorrelate-gui - correlates digital photos with GPS data filling EXIF fields (GUI)
graywolf - Placement for digital VLSI design
grip - Preview GitHub Markdown files like Readme locally
gtkam - application for retrieving media from digital cameras
gtkam-gimp - gtkam gimp plugin to open digital camera pictures
gtkmorph - Digital image warp and morph (gtk)
gtkmorph-example - digital image warp and morph, examples
guile-git - guile bindings for libgit2
guilt - quilt for git; similar to Mercurial queues
hamradio-digitalvoice - Debian Hamradio Digital Voice Packages
homesick - keep your dotfiles (configs) in git
hub - make git easier with GitHub
iannix - graphical OSC sequencer for digital arts
idle3-tools - change the idle3 timer of recent Western Digital Hard Disk Drives
inkscape-survex-export - Inkscape plugin to digitise printed surveys
jgit-cli - Java implementation of GIT version control (command line interface)
jigit - tools for working with jigdo files
js8call - Amateur Radio Digital Mode providing weak signal messaging
kamera - digital camera support for KDE applications
keyringer - Distributed secret management using GnuPG and Git
kino - Non-linear editor for Digital Video data
klaus - simple easy-to-set-up Git web viewer
kodi-pvr-octonet - Digital Devices Octopus NET PVR for Kodi
ldap-git-backup - Back up LDAP database in an Git repository
legit - Git extension to assist in manipulating branches
letterize - phone digits to letter-mnemonics
libalgorithm-checkdigits-perl - Perl extension to generate and test check digits
libapi-gitforge-perl - generic interface to APIs of sites like GitHub, GitLab etc.
libcdio-cdda-dev - library to read and control digital audio CDs (development files)
libcdio-paranoia-dev - library to read digital audio CDs with error correction (development files)
libcgi-github-webhook-perl - Easily write CGI-based GitHub webhooks in Perl
libcmark-gfm-dev - CommonMark GitHub flavor gfm library dev files
libcmark-gfm-extensions-dev - CommonMark GitHub flavor gfm extensions library dev files
libcmark-gfm-extensions0.29.0.gfm.3 - CommonMark GitHub flavor gfm extension library
libcmark-gfm0.29.0.gfm.3 - CommonMark GitHub flavor gfm library
libconfig-gitlike-perl - Perl module for Git-compatible config file parsing
libdc1394-25 - high level programming interface for IEEE 1394 digital cameras
libdc1394-dev - high level programming interface for IEEE 1394 digital cameras - development
libdc1394-doc - high level programming interface for IEEE 1394 digital cameras - documentation
libdc1394-utils - utilities for IEEE 1394 digital cameras
libdist-inkt-role-git-perl - git functions for Dist::Inkt
libdist-zilla-plugin-changelogfromgit-perl - Dist::Zilla plugin to build a Changes file from a project's git log
libdist-zilla-plugin-config-git-perl - Dist::Zilla Git plugin configuration settings module
libdist-zilla-plugin-git-perl - Dist::Zilla plugins to update your git repository after release
libdist-zilla-plugin-githubmeta-perl - Automatically include GitHub meta information in META.yml
libdist-zilla-plugin-repository-perl - Dist::Zilla plugin to discovery repository URL from svn/svk/Git checkout
libdsdcc-dev - Digital Speech Decoder (DSD) (headers)
libdsdcc1 - Digital Speech Decoder (DSD)
libdv-bin - software library for DV format digital video (sample apps)
libg15-1 - Library for interfacing with the Logitech G15 keyboards
libg15-dev - Library for interfacing with the Logitech G15 keyboards
libg15render-dev - Library for interfacing with the Logitech G15 keyboards
libg15render1 - Library for interfacing with the Logitech G15 keyboards
libg810-led-dev - Logitech keyboard LED configuration library (development)
libg810-led0 - Logitech keyboard LED configuration library (runtime)
libgeo-coordinates-utm-perl - Perl extension for Latitiude Longitude conversions
libghc-cmark-gfm-dev - fast, accurate GitHub Flavored Markdown parser and renderer
libghc-cmark-gfm-doc - fast, accurate GitHub Flavored Markdown parser and renderer; documentation
libghc-cmark-gfm-prof - fast, accurate GitHub Flavored Markdown parser and renderer; profiling libraries
libghc-git-lfs-dev - git-lfs protocol for Haskell
libghc-git-lfs-doc - git-lfs protocol for Haskell; documentation
libghc-git-lfs-prof - git-lfs protocol for Haskell; profiling libraries
libghc-githash-dev - Compile git revision info into Haskell projects
libghc-githash-doc - Compile git revision info into Haskell projects; documentation
libghc-githash-prof - Compile git revision info into Haskell projects; profiling libraries
libghc-github-dev - Haskell Github API
libghc-github-doc - Haskell Github API; documentation
libghc-github-prof - Haskell Github API; profiling libraries
libghc-gitit-data - Wiki engine backed by a git or darcs filestore - Data files
libghc-gitit-dev - Wiki engine backed by a git or darcs filestore
libghc-gitit-doc - Wiki engine backed by a git or darcs filestore; documentation
libghc-gitit-prof - Wiki engine backed by a git or darcs filestore; profiling libraries
libghc-gitrev-dev - compile git revision info into Haskell projects
libghc-gitrev-doc - compile git revision info into Haskell projects; documentation
libghc-gitrev-prof - compile git revision info into Haskell projects; profiling libraries
libgit-annex-perl - Perl interface to git-annex repositories
libgit-objectstore-perl - abstraction layer for Git::Raw and libgit2
libgit-pureperl-perl - Pure Perl interface to Git repositories
libgit-raw-perl - Perl bindings to the Git linkable library (libgit2)
libgit-repository-perl - Perl interface to Git repositories
libgit-repository-plugin-log-perl - Git::Repository plugin adding log items
libgit-sub-perl - git commands imported as System::Sub subs in the git:: namespace
libgit-version-compare-perl - module to compare Git versions
libgit2-1.1 - low-level Git library
libgit2-dev - low-level Git library (development files)
libgit2-fixtures - low-level Git library - test suite examples
libgit2-glib-1.0-0 - glib wrapper library around the libgit2 git access library
libgit2-glib-1.0-dev - glib wrapper library around the libgit2 git access library - development files
libgit2-glib-1.0-doc - glib wrapper library around the libgit2 git access library - documentation
libgnuradio-digital3.10.1 - gnuradio digital communications functions
libgnuradio-dtv3.10.1 - gnuradio digital TV signal processing blocks
libham-locator-perl - Perl module for converting between Maidenhead locators and latitude/longitude
libjgit-ant-java - Java implementation of GIT version control (Ant interface)
libjgit-java - Java implementation of GIT version control
libjs-jquery-gitgraph - convert git log --graph to image with HTML5 canvas
liblur-dev - Logitech Unifying Receiver access library - dev files
liblur3 - Logitech Unifying Receiver access library
libmorph - digital image warping library
libmorph-dev - digital image warping library (development files)
libnet-github-perl - Perl interface for GitHub
libnoggit-java - Fast streaming JSON parser for Java
libpithub-perl - Github v3 API
librtfilter-dev - realtime digital filtering library (development files)
librtfilter1 - realtime digital filtering library
librtfilter1-dbg - realtime digital filtering library (debugging symbols)
librust-bat-dev - Cat(1) clone with wings - Rust source code
librust-git-absorb-dev - Git commit --fixup, but automatic - Rust source code
librust-git2+default-dev - Bindings to libgit2 for interoperating with git repositories - feature "default"
librust-git2+https-dev - Bindings to libgit2 for interoperating with git repositories - feature "https"
librust-git2+openssl-probe-dev - Bindings to libgit2 for interoperating with git repositories - feature "openssl-probe"
librust-git2+openssl-sys-dev - Bindings to libgit2 for interoperating with git repositories - feature "openssl-sys"
librust-git2+ssh-dev - Bindings to libgit2 for interoperating with git repositories - feature "ssh"
librust-git2+ssh-key-from-memory-dev - Bindings to libgit2 for interoperating with git repositories - feature "ssh_key_from_memory"
librust-git2-curl-dev - Backend for an HTTP transport in libgit2 powered by libcurl - Rust source code
librust-git2-dev - Bindings to libgit2 for interoperating with git repositories - Rust source code
librust-ignore-dev - Fast library for efficiently matching ignore files such as `.gitignore` against file paths - Rust source code
librust-libgit2-sys+https-dev - Native bindings to the libgit2 library - feature "https" and 1 more
librust-libgit2-sys+libssh2-sys-dev - Native bindings to the libgit2 library - feature "libssh2-sys" and 1 more
librust-libgit2-sys-dev - Native bindings to the libgit2 library - Rust source code
librust-winapi-dev - Raw FFI bindings for all of Windows API - Rust source code
libtest-requires-git-perl - module to check the available version of Git
libtools-gitlibs-clojure - API for retrieving, caching, and programmatically accessing git libraries
libxml-security-c-dev - C++ library for XML Digital Signatures (development)
libxml-security-c20 - C++ library for XML Digital Signatures (runtime)
lifeograph - Private digital diary
logiops - Configuration utility for Logitech mice and keyboards
logitech-applet - Logitech mouse tweaking utility
lomoco - Logitech Mouse Control for USB mice
ltunify - manage Logitech unifying receivers
lur-command - Logitech Unifying Receiver control tool
mate-submodules-source - MATE code components provided as Git submodule repository
mercurial-git - Git plugin for Mercurial
metacam - extract EXIF information from digital camera files
mgitstatus - Show status of multiple Git repositories
minetest-mod-mesecons - Digital circuitry blocks for minetest
mixxx - Digital Disc Jockey Interface
mixxx-data - Digital Disc Jockey Interface -- data files
mopidy-dleyna - Mopidy extension for playing music from Digital Media Servers
mtpaint - painting program to create pixel art and manipulate digital photos
multimedia-photography - Packages for working with digital photography
multimon-ng - digital radio transmission decoder
node-github-url-from-git - Convert github git or gist url to an http url - Node.js module
node-hosted-git-info - Provides metadata from Github, Bitbucket and Gitlab
node-ignore - manager and filter for .gitignore rules - Node.js library
node-normalize-git-url - normalizes Git URLs
node-re2 - Node.js bindings for RE2, a fast and safe regular expression engine
npm - package manager for Node.js
octicons - GitHub's icons webfont
opencfu - count cell colonies (CFUs) on agar plates by processing digital pictures
orthanc-wsi - Whole-slide imaging support for Orthanc (digital pathology)
pagure - git-centered forge using pygit2
pagure-ci - git-centered forge using pygit2 - CI integration server
pagure-doc - git-centered forge using pygit2 (documentation)
pagure-ev-server - git-centered forge using pygit2 - EventSource server
pagure-loadjson - git-centered forge using pygit2 - JSON load server
pagure-logcom - git-centered forge using pygit2 - commit log server
pagure-milters - git-centered forge using pygit2 - milters (mail filters)
pagure-mirror - git-centered forge using pygit2 - mirror
pagure-webhook - git-centered forge using pygit2 - web-hook server
pass-git-helper - Git credential helper interfacing with pass
pd-cmos - digital logic emulator objects for Pure Data (Pd)
photopc - Interface to digital still cameras
phpunit-git - Simple wrapper for Git
phpunit-version - Library that helps with managing the version number of Git-hosted PHP projects
piuparts-master-from-git-deps - dependencies for running piuparts master from git
piuparts-slave-from-git-deps - dependencies for running piuparts slave from git
powerline-gitstatus - Powerline Git segment
pre-commit - Git pre-commit hook framework
pristine-lfs - regenerate pristine tarballs from git-lfs
projecteur - virtual laser pointer for Logitech Spotlight devices
puppet-module-cirrax-gitolite - puppet module to configure gitolite
python-certbot-dns-digitalocean-doc - Documentation for the DigitalOcean DNS plugin for Certbot
python-digitalocean-doc - Python bindings for the DigitalOcean API (common documentation)
python-django-taggit-doc - simple tagging for Django (Documentation)
python-git-doc - Python library to interact with Git repositories - docs
python-gitlab-doc - Python 3 GitLab API client library - documentation
python-pygit2-doc - bindings for libgit2 - doc
python3-annexremote - abstraction for git-annex special remote implementations
python3-bme280 - Python interface for a Bosch BME280 digital sensor module
python3-certbot-dns-digitalocean - DigitalOcean DNS plugin for Certbot
python3-click-didyoumean - enables git-like did-you-mean feature in click
python3-cmarkgfm - GitHub-flavored Markdown renderer Python bindings
python3-dfdatetime - Digital Forensics date and time library for Python 3
python3-dfvfs - Digital Forensics Virtual File System
python3-dfwinreg - Digital Forensics Windows Registry library for Python 3
python3-digitalocean - Python bindings for the DigitalOcean API (Python 3)
python3-django-taggit - simple tagging for Django (Python 3)
python3-dulwich - Python Git library - Python3 module
python3-ghdiff - Generator of Github-style HTML for unified diffs
python3-git - Python library to interact with Git repositories - Python 3.x
python3-git-os-job - Show the OpenStack job logs for a commit - Python 3.x
python3-git-repo-updater - Tool to update multiple git repositories at once (Python 3)
python3-gitdb - pure-Python git object database (Python 3)
python3-github - Access the full Github API v3 from Python3
python3-gitlab - Python 3 GitLab API client library
python3-klaus - simple easy-to-set-up Git web viewer
python3-nbgitpuller - Notebook Extension to do one-way synchronization of git repo
python3-pathspec - utility library for gitignore style pattern matching of file paths (Python 3)
python3-powerline-gitstatus - Powerline Git segment for Python (3.x)
python3-pybadges - library for creating Github-style badges (Python3 version)
python3-pygit2 - bindings for libgit2 - Python 3.x
python3-pyo - Python3 module written in C to help digital signal processing script creation
python3-setuptools-git - plugin for setuptools that enables git integration
python3-setuptools-scm-git-archive - Plugin for setuptools_scm to add support for git archives
python3-vcstools - VCS/SCM Python source control library for svn, git, hg, and bzr (Python 3)
qflow - Open-Source Digital Synthesis Flow
qgit - Qt application for viewing GIT trees
r-bioc-edger - Empirical analysis of digital gene expression data in R
r-cran-askpass - safe password entry for GNU R, Git, and SSH
r-cran-commonmark - high performance CommonMark and Github markdown rendering in R
r-cran-credentials - GNU R tools for managing SSH and Git credentials
r-cran-gert - simple git client for GNU R
r-cran-gh - GNU R Minimal client to access the 'GitHub' 'API'
r-cran-git2r - GNU R access to Git repositories
r-cran-gitcreds - query 'git' credentials from GNU R
r-cran-remotes - R Package Installation from Remote Repositories, Including 'GitHub'
rawtherapee - raw image converter and digital photo processor
rawtherapee-data - raw image converter and digital photo processor (data files)
ruby-chronic - natural language date parser
ruby-chronic-duration - simple Ruby natural language parser for elapsed time
ruby-ed25519 - efficient digital signature library providing the Ed25519 algorithm
ruby-et-orbi - Time zones for fugit and rufus-scheduler
ruby-fugit - time tools for Ruby and flor
ruby-gh - multi-layer client for the GitHub API v3
ruby-git - Ruby interface to the Git revision control system
ruby-github-api - Ruby client for the official GitHub API
ruby-github-linguist - detection and highlight of the programming language of source code
ruby-github-markdown - Markdown parser for GitHub.com
ruby-github-markup - GitHub Markup rendering
ruby-github-pages-health-check - check GitHub Pages for common DNS configuration issues
ruby-gitlab - Ruby wrapper and CLI for the GitLab API
ruby-gitlab-experiment - GitLab experiment library built on top of scientist
ruby-gitlab-flowdock-git-hook - Git Post-Receive hook for Flowdock
ruby-gitlab-fog-azure-rm - Azure Blob Storage with CarrierWave and Fog
ruby-gitlab-license-finder - Audit the OSS licenses of your application's dependencies
ruby-gitlab-sidekiq-fetcher - Reliable fetch extension for Sidekiq
ruby-gollum-lib - simple, Git-powered wiki
ruby-gollum-rugged-adapter - Adapter for Gollum to use Rugged (libgit2) at the backend
ruby-grack - Git Smart HTTP Server Rack implementation in Ruby/Rack
ruby-grit - Ruby Git bindings
ruby-html-pipeline - GitHub HTML processing filters and utilities
ruby-jekyll-avatar - Jekyll plugin for rendering GitHub avatars
ruby-jekyll-gist - Liquid tag for displaying GitHub Gists in Jekyll sites
ruby-jekyll-github-metadata - Jekyll plugin to propagate the site.github namespace
ruby-jekyll-remote-theme - plugin for building Jekyll sites with any GitHub-hosted theme
ruby-mail-room - Forward mail from gmail IMAP to a callback URL or job worker, simply
ruby-net-dns - Pure Ruby DNS library
ruby-octokit - Ruby toolkit for working with the GitHub API
ruby-omniauth-github - GitHub strategy for the Ruby OmniAuth library
ruby-omniauth-gitlab - OAuth2 strategy for authenticating to GitLab service
ruby-pathspec - Library to match path patterns such as gitignore
ruby-rugged - Ruby binding to the libgit2 library
ruby-task-list - GitHub-flavored-Markdown TaskList components
schleuder-gitlab-ticketing - filter plugin to hook Schleuder into a GitLab issue tracker
solaar - Logitech Unifying Receiver peripherals manager for Linux
stgit - manage stacks of patches in a git repository
stgit-contrib - set of contributed script to help working with stgit
svn-all-fast-export - fast-import based converter to convert repos from Subversion to git
svn2git - Ruby tool for migrating svn projects to git
ticgit - ticketing system built on Git
ticgitweb - web interface to ticgit
tig - ncurses-based text-mode interface for Git
tkgate - Tcl/Tk based digital circuit editor and simulator
tkgate-data - Tcl/Tk based digital circuit editor and simulator - data files
tkgate-doc - Tcl/Tk based digital circuit editor and simulator - documentation
tmux-plugin-manager - tmux plugin manager based on git
topgit - a Git patch queue manager
unity-scope-home - Home scope that aggregates results from multiple scopes
userv-git-daemon - per-user git daemon service
vcsh - Version Control System for $HOME - multiple Git repositories in $HOME
vim-fugitive - Vim plugin to work with Git
vim-git-hub - Vim runtime files for git-hub
vim-gitgutter - Vim plugin which shows a git diff in the sign column
webp - Lossy compression of digital photographic images
xandikos - Git-backed CalDAV/CardDAV server
xdaliclock - Melting digital clock
xfce4-dev-tools - Script to help building Xfce from git
xml-security-c-utils - C++ library for XML Digital Signatures (utilities)
xmorph - digital image warp and morph (x11)
xoscope - digital oscilloscope
zita-dpl1 - digital peak level limiter
zoph - Web based digital image presentation and management system
repo - repository management tool built on top of git
steam-installer - Installer for Valve's Steam digital software delivery system
