apt-cache search lua
aodh-evaluator - OpenStack Telemetry (Ceilometer) Alarming - alarm evaluator
cpu-checker - tools to help evaluate certain CPU (or BIOS) features
libipa-hbac-dev - FreeIPA HBAC Evaluator library -- development files
libipa-hbac0 - FreeIPA HBAC Evaluator library
liblua5.3-0 - Shared library for the Lua interpreter version 5.3
liblua5.3-0-dbg - Debug symbols for the Lua shared library interpreter
liblua5.3-dev - Development files for the Lua language version 5.3
libtexlua53 - TeX Live: Lua 5.3, modified for use with LuaTeX
libtexlua53-dev - TeX Live: Lua 5.3, modified for use with LuaTeX (development part)
libtexluajit-dev - TeX Live: LuaJIT, modified for use with LuaJITTeX (development part)
libtexluajit2 - TeX Live: LuaJIT, modified for use with LuaJITTeX
lua-rrd - time-series data storage and display system (Lua interfaces)
lua-rrd-dev - time-series data storage and display system (Lua development)
apertium-eval-translator - Evaluate machine translation output against reference
babel-minify - ES6+ aware minifier based on the Babel toolchain
bpfcc-lua - Standalone tool to run BCC tracers written in Lua
cantor-backend-lua - Lua backend for Cantor
civetweb - embeddable web server with optional CGI, SSL and Lua support
cpuset - Allows manipluation of cpusets and provides higher level fun
devilspie2 - Lua-based window matching utility
dh-lua - helper tools for maintaining Lua-related packages
dnsmasq-base-lua - Small caching DNS proxy and DHCP/TFTP server
dovecot-auth-lua - secure POP3/IMAP server - Lua authentication plugin
drs4eb - DRS4 Evaluation Board software
eja - micro web server for static and dynamic Lua generated content
elpa-lua-mode - Emacs major-mode for editing Lua programs
erlang-luerl - implementation of Lua in Erlang
fcitx-module-lua - Flexible Input Method Framework - Lua module
fcitx5-module-lua - Lua support for fcitx5
fcitx5-module-lua-common - Lua support for fcitx5 (common files)
fcitx5-module-lua-dev - Lua support for fcitx5 (development files)
geany-plugin-lua - Lua scripting plugin for Geany
gimp-gluas - Lua environment plug-in for GIMP
golang-github-antonmedv-expr-dev - expression evaluation engine for Go
golang-github-brentp-goluaez-dev - Easy embedding Lua in go
golang-github-hashicorp-go-bexpr-dev - generic boolean expression evaluation in Golang
golang-github-yuin-gluare-dev - Regular expression library for the GopherLua
golang-github-yuin-gopher-lua-dev - virtual machine and compiler for Lua in Go
golang-layeh-gopher-luar-dev - Simplifies data passing between Go and GopherLua
hexchat-lua - Lua plugin for HexChat
jel-java - Library for evaluating algebraic expressions in Java
kamailio-lua-modules - app_lua module for Kamailio Lua support
king-probe - Evaluate and visualize protein interatomic packing
libcivetweb-dev - embeddable web server with optional CGI, SSL and Lua support (devel)
libcivetweb1 - embeddable web server with optional CGI, SSL and Lua support (lib)
libcsnd-dev - development files for Csound -- C++ API
libelua-bin - EFL Lua wrapper and convenience layer - binaries
libelua1 - EFL Lua wrapper and convenience layer
libfungw-lua1 - Scripting support for fungw: lua
libghc-hslua-dev - Lua language interpreter embedding in Haskell
libghc-hslua-doc - Lua language interpreter embedding in Haskell; documentation
libghc-hslua-module-system-dev - Lua module wrapper around Haskell's System module
libghc-hslua-module-system-doc - Lua module wrapper around Haskell's System module; documentation
libghc-hslua-module-system-prof - Lua module wrapper around Haskell's System module; profiling libraries
libghc-hslua-module-text-dev - Lua module for text
libghc-hslua-module-text-doc - Lua module for text; documentation
libghc-hslua-module-text-prof - Lua module for text; profiling libraries
libghc-hslua-prof - Lua language interpreter embedding in Haskell; profiling libraries
libghc-mueval-dev - safely evaluate pure Haskell expressions
libghc-mueval-doc - safely evaluate pure Haskell expressions; documentation
libghc-mueval-prof - safely evaluate pure Haskell expressions; profiling libraries
libghc-tasty-lua-dev - Write tests in Lua, integrate into tasty
libghc-tasty-lua-doc - Write tests in Lua, integrate into tasty; documentation
libghc-tasty-lua-prof - Write tests in Lua, integrate into tasty; profiling libraries
libgv-lua - Lua bindings for graphviz
libint-dev - Evaluate the integrals in modern atomic and molecular theory (devel)
libint1 - Evaluate the integrals in modern atomic and molecular theory
libint2-2 - Computation Chemistry Integral Evaluation Library
libint2-dev - Computation Chemistry Integral Evaluation Library (development files)
liblcm-lua - Lightweight Communications and Marshalling
liblua5.1-0 - Shared library for the Lua interpreter version 5.1
liblua5.1-0-dbg - Debug symbols for the Lua shared library interpreter
liblua5.1-0-dev - Development files for the Lua language version 5.1
liblua5.1-bitop-dev - Transitional package for lua-bitop-dev
liblua5.1-bitop0 - Transitional package for lua-bitop
liblua5.1-luacsnd - Lua bindings for the Csound API
liblua5.2-0 - Shared library for the Lua interpreter version 5.2
liblua5.2-dev - Development files for the Lua language version 5.2
liblua5.4-0 - Shared library for the Lua interpreter version 5.4
liblua5.4-0-dbg - Debug symbols for the Lua shared library interpreter
liblua5.4-dev - Development files for the Lua language version 5.4
libluabind-dev - luabind c++ binding for Lua: static library and headers
libluabind-doc - luabind c++ binding for Lua: documentation files
libluabind-examples - luabind c++ binding for Lua: example files
libluabind0.9.1d1 - luabind c++ binding for Lua: runtime library
libluajit-5.1-2 - Just in time compiler for Lua - library version
libluajit-5.1-common - Just in time compiler for Lua - common files
libluajit-5.1-dev - Just in time compiler for Lua - development files
liblutok-dev - lightweight C++ API library for Lua -- development files
liblutok-doc - lightweight C++ API library for Lua -- documentation
liblutok3 - lightweight C++ API library for Lua -- shared object
libmatheval-dev - GNU library for evaluating symbolic mathematical expressions (development)
libmatheval1 - GNU library for evaluating symbolic mathematical expressions (runtime)
libplplot-lua - Scientific plotting library (Lua bindings)
libprelude-lua - Security Information and Events Management system [ Lua bindings ]
libquvi-scripts-0.9 - library for parsing video download links (Lua scripts)
librime-plugin-lua - Rime Input Method Engine - Lua extension plugin
librobottestingframework-lua2 - Robot Testing Framework - RTF_lua library
librust-cexpr-dev - C expression parser and evaluator - Rust source code
librust-fasteval-dev - Fast evaluation of algebraic expressions - Rust source code
librust-lazy-static+spin-dev - Macro for declaring lazily evaluated statics - feature "spin" and 1 more
librust-lazy-static-dev - Macro for declaring lazily evaluated statics - Rust source code
librust-lua52-sys-dev - Bindings for Lua 5.2 - Rust source code
librust-matches-dev - Macro to evaluate, as a boolean, whether an expression matches a pattern - Rust source code
librust-semver+serde-dev - Parser and evaluator for Cargo's flavor of Semantic Versioning - feature "serde"
librust-semver-dev - Parser and evaluator for Cargo's flavor of Semantic Versioning - Rust source code
librust-typenum-dev - Type-level numbers evaluated at compile time - Rust source code
libscalar-defer-perl - module providing lazy evaluation for Perl
libtolua++5.1-dev - extended tool to integrate C/C++ code with Lua (devel)
libtolua-dev - Tool to integrate C/C++ code with Lua - development files
libtrilinos-phalanx-13.2 - local field evaluation kernel - runtime files
libtrilinos-phalanx-dev - local field evaluation kernel - development files
lighttpd-modules-lua - LUA-based modules for lighttpd
lmod - Lua based environment modules
looptools - Integral Evaluator of One-loop Feynman Diagram
love - 2D game development framework based on Lua and OpenGL
lua-ansicolors - simple Lua function for printing to the console in color
lua-any - helper script for shebang lines in Lua scripts
lua-apr - Apache Portable Runtime library for the Lua language
lua-apr-dev - Lua development files for the Apache Portable Runtime library
lua-apr-doc - Lua documentation files for the Apache Portable Runtime library
lua-argparse - feature-rich command line parser for Lua language
lua-augeas - Lua binding to the Augeas C API
lua-axtlsl - Highly configurable client/server TLSv1.2 library (Lua binding)
lua-basexx - baseXX encoding/decoding library for Lua
lua-binaryheap - Binary heap implementation in Lua
lua-bit32 - Backport of the Lua 5.2 bit32 library to Lua 5.1
lua-bit32-dev - Development files for the bit32 library for Lua 5.1
lua-bitop - fast bit manipulation library for the Lua language
lua-bitop-dev - fast bit manipulation library devel files for the Lua language
lua-busted - Lua unit testing framework focused on ease of use
lua-cgi - CGI library for the Lua language
lua-check - static analyzer and a linter for the Lua language
lua-cjson - JSON parser/encoder for Lua
lua-cjson-dev - JSON parser/encoder for Lua, development files
lua-cliargs - command-line argument parsing module for Lua
lua-compat53 - Lua-5.3-style APIs for Lua 5.2 and 5.1
lua-compat53-dev - Lua-5.3-style APIs for Lua 5.2 and 5.1 (development files)
lua-copas - Copas is a dispatcher of concurrent TCP/IP requests
lua-cosmo - Template library for the Lua language
lua-coxpcall - Protected function calls across coroutines for Lua
lua-cqueues - event loop for Lua
lua-cqueues-dev - event loop for Lua (development package)
lua-curl - libcURL bindings for the Lua language
lua-curl-dev - libcURL development files for the Lua language
lua-curses - curses library bindings for the Lua language
lua-curses-dev - Development files for the lua-curses library
lua-cyrussasl - Cyrus SASL library for the Lua language
lua-cyrussasl-dev - Cyrus SASL development files for the Lua language
lua-dbi-common - DBI library for the Lua language, common files
lua-dbi-mysql - DBI library for the Lua language, MySQL backend
lua-dbi-mysql-dev - DBI library for the Lua language, MySQL development files
lua-dbi-postgresql - DBI library for the Lua language, PostgreSQL backend
lua-dbi-postgresql-dev - DBI library for the Lua language, PostgreSQL development files
lua-dbi-sqlite3 - DBI library for the Lua language, sqlite3 backend
lua-dbi-sqlite3-dev - DBI library for the Lua language, sqlite3 development files
lua-discount - Discount library for the Lua language
lua-discount-dev - discount development files for the Lua language
lua-dkjson - JSON module written in Lua
lua-doc - Documentation generator for lua
lua-event - asynchronous event notification library for Lua
lua-event-dev - libevent development files for the Lua language
lua-expat - libexpat bindings for the Lua language
lua-expat-dev - libexpat development files for the Lua language
lua-fifo - FIFO implementation for Lua
lua-filesystem - luafilesystem library for the Lua language
lua-filesystem-dev - luafilesystem development files for the Lua language
lua-geoip - GeoIP library bindings for the Lua language
lua-geoip-dev - Development files for lua-geoip library
lua-guestfs - guest disk image management system - Lua bindings
lua-hamlib - Run-time Lua library to control radio transceivers and receivers
lua-hamlib2 - Transitional package depending on lua-hamlib
lua-http - HTTP library for Lua
lua-iconv - iconv bindings for the Lua programming language
lua-iconv-dev - iconv bindings for Lua - development files
lua-inifile - simple, complete ini parser for Lua
lua-inotify - inotify bindings for Lua
lua-inotify-dev - inotify bindings for Lua (development files)
lua-inspect - Lua table visualizer, ideal for debugging
lua-json - JSON decoder/encoder for Lua
lua-ldap - LDAP library for the Lua language
lua-ldap-dev - LDAP development files for the Lua language
lua-ldoc - LuaDoc-compatible documentation generation system
lua-leg - Lua 5.1 grammar, with parsing and manipulation facilities
lua-leg-dev - Leg development files for the Lua language
lua-lemock - LeMock (Lua Easy Mock) for unit test
lua-lemock-dev - LeMock (Lua Easy Mock) for unit test
lua-lgi - Lua bridge to GObject based libraries
lua-lgi-dev - lgi development files for the Lua language
lua-ljsyscall - Unix system calls for LuaJIT
lua-logging - Logging library for the Lua language
lua-lpeg - LPeg library for the Lua language
lua-lpeg-dev - LPeg development files for the Lua language
lua-lpeg-patterns - collection of LPEG patterns
lua-lpty - PTY library for the Lua language
lua-lpty-dev - PTY library for the Lua language - development files
lua-luaossl - OpenSSL bindings for Lua
lua-luaossl-dev - OpenSSL bindings for Lua (development package)
lua-luassert - Lua assertions extension
lua-luv - libuv bindings for Lua
lua-luv-dev - libuv bindings for Lua (development files)
lua-lxc - Linux Containers userspace tools (Lua bindings)
lua-markdown - Pure Lua 5.1 implementation of the Markdown text-to-html markup
lua-md5 - MD5 library for the Lua language
lua-md5-dev - MD5 library for the Lua language
lua-mediator - Mediator pattern implementation in Lua
lua-messagepack - pure Lua implementation of MessagePack
lua-mmdb - IP geolocation library for Lua
lua-moses - Utility library for functional programming in Lua
lua-mpack - libmpack binding for the Lua language
lua-nginx-cookie - Pure Lua cookie parser for the nginx embedded Lua language
lua-nginx-dns - DNS resolver for the nginx embedded Lua language
lua-nginx-kafka - Pure Lua Kafka producer for the nginx embedded Lua language
lua-nginx-memcached - Pure Lua memcached client driver for the nginx embedded Lua language
lua-nginx-redis - Pure Lua redis client driver for the nginx embedded Lua language
lua-nginx-redis-connector - Connection utilities for lua-nginx-redis
lua-nginx-string - String utilities for the nginx embedded Lua language
lua-nginx-websocket - Lua websocket client driver for the nginx embedded Lua language
lua-nvim - Lua client for Neovim
lua-nvim-dev - Lua client for Neovim
lua-orbit - MVC web framework for Lua
lua-penlight - Collection of general purpose libraries for the Lua language
lua-penlight-dev - Collection of general purpose libraries for the Lua language
lua-posix - posix library for the Lua language
lua-posix-dev - posix development files for the Lua language
lua-readline - readline library for the Lua language
lua-readline-dev - readline development files for the Lua language
lua-redis - Redis client database library for the Lua language
lua-redis-dev - Redis client library for the Lua language, examples and tests
lua-rex-doc - documentation of the rex library for the Lua language
lua-rex-gnu - GNU regular expressions library for the Lua language
lua-rex-gnu-dev - GNU development files for the Lua language
lua-rex-onig - Onig regular expressions library for the Lua language
lua-rex-onig-dev - Onig regex development files for the Lua language
lua-rex-pcre2 - Perl regular expressions library (PCRE2) for the Lua language
lua-rex-pcre2-dev - PCRE2 development files for the Lua language
lua-rex-posix - POSIX regular expressions library for the Lua language
lua-rex-posix-dev - POSIX regex development files for the Lua language
lua-rex-tre - TRE regular expressions library for the Lua language
lua-rex-tre-dev - TRE development files for the Lua language
lua-rings - Lua state creation and control library for the Lua language
lua-rings-dev - Development files for the rings library for the Lua language
lua-say - Lua string hashing/indexing library
lua-sec - SSL socket library for the Lua language
lua-sec-dev - SSL socket library devel files for the Lua language
lua-soap - SOAP library for the Lua language
lua-socket - TCP/UDP socket library for the Lua language
lua-socket-dev - luasocket development files for the Lua language
lua-sql-doc - luasql documentation
lua-sql-mysql - luasql library for the Lua language
lua-sql-mysql-dev - luasql development files for the Lua language
lua-sql-odbc - luasql library for the Lua language
lua-sql-odbc-dev - luasql development files for the Lua language
lua-sql-postgres - luasql library for the Lua language
lua-sql-postgres-dev - luasql development files for the Lua language
lua-sql-sqlite3 - luasql library for the Lua language
lua-sql-sqlite3-dev - luasql development files for the Lua language
lua-svn - Subversion library for the Lua language
lua-svn-dev - Development files for the Subversion library for the Lua language
lua-swupdate - swupdate bindings for the Lua language
lua-system - platform independent system call library for Lua
lua-system-dev - development files for lua-system
lua-systemd - Systemd bindings for Lua
lua-systemd-dev - Development files for lua-systemd library
lua-term - Lua module for manipulating a terminal
lua-term-dev - Lua module for manipulating a terminal
lua-unbound - Unbound bindings for the Lua language
lua-unbound-dev - Development files for unbound bindings for the Lua language
lua-unit - Lua unit testing framework
lua-uri - pure Lua library to normalize and validate URIs/URLs
lua-uri-dev - examples and test files for lua-uri
lua-wsapi - Web server API abstraction layer for the Lua language
lua-wsapi-doc - wsapi documentation files for the Lua language
lua-wsapi-fcgi - Web server API fastcgi backend
lua-wsapi-fcgi-dev - wsapi fastcgi development files for the Lua language
lua-xmlrpc - xmlrpc library for the Lua language
lua-yaml - LibYAML binding for Lua
lua-yaml-dev - docs and test files for lua-yaml
lua-zip - zip library for the Lua language
lua-zip-dev - zip development files for the Lua language
lua-zlib - zlib library for the Lua language
lua-zlib-dev - zlib development files for the Lua language
lua5.1 - Simple, extensible, embeddable programming language
lua5.1-doc - Documentation for the Lua language version 5.1
lua5.1-policy - Lua 5.1 Debian policy
lua5.1-policy-dev - Lua 5.1 Debian policy - template and scripts
lua5.2 - Simple, extensible, embeddable programming language
lua5.2-doc - Documentation for the Lua language version 5.2
lua5.3 - Simple, extensible, embeddable programming language
lua5.4 - Simple, extensible, embeddable programming language
luadoc - Documentation generation library for the Lua language
luajit - Just in time compiler for Lua programming language version 5.1
luakit - fast and small web browser extensible by Lua
luarocks - deployment and management system for Lua modules
mueval - Safely evaluate pure Haskell expressions - executables
nbdkit-plugin-lua - Lua plugin for nbdkit
node-constantinople - determine if an expression evaluates to a constant - Node.js module
node-d3-queue - Evaluate asynchronous tasks with configurable concurrency
node-lodash-reevaluate - modern build of lodash??s internal `reEvaluate` as a module
node-static-eval - evaluate statically-analyzable javascript expressions
nthash - Methods to evaluate runtime and uniformity tests for hashing methods
pd-lua - Lua bindings for Pure Data
pdns-backend-lua2 - Lua2 backend for PowerDNS
perlconsole - small program that lets you evaluate Perl code interactively
php-luasandbox - PHP extension that provides a sandboxed Lua environment
php-symfony-expression-language - compile and evaluate expressions
postgresql-14-pllua - Lua procedural language for PostgreSQL 14
python-pyluach-doc - Hebrew dates and Hebrew-Gregorian conversions (Documentation)
python3-asteval - minimalistic evaluator of Python 3 expression using ast module
python3-cpuset - manipluation of cpusets and provides higher level fun - Python 3.x
python3-dicteval - Library to evaluate expressions in dict/json objects
python3-lazyarray - Python module providing a NumPy-compatible lazily-evaluated array
python3-libipa-hbac - Python3 bindings for the FreeIPA HBAC Evaluator library
python3-lupa - Python wrapper around LuaJIT or Lua (Python3 version)
python3-numexpr - Fast numerical array expression evaluator for Python 3 and NumPy
python3-pure-eval - Safely evaluate Python AST nodes without side effects
python3-pyluach - Hebrew dates and Hebrew-Gregorian conversions (Python3 version)
python3-simpleeval - Simple, safe single expression evaluator library (Python 3)
python3-torch-ignite - High-level library to help with training and evaluating in PyTorch
r-bioc-biocparallel - BioConductor facilities for parallel evaluation
r-cran-contfrac - GNU R package providing various utilities for evaluating continued fractions
r-cran-cutpointr - GNU R determine and evaluate optimal cutpoints in binary
r-cran-evaluate - GNU R parsing and evaluation tools
r-cran-lazyeval - GNU R lazy (non-standard) evaluation
r-cran-metrics - GNU R evaluation metrics for machine learning
r-cran-mlmetrics - GNU R machine learning evaluation metrics
r-cran-whatif - GNU R evaluate counterfactuals
reapr - universal tool for genome assembly evaluation
ruby-cleanroom - Ruby module for safer evaluation of Ruby DSLs
ruby-declarative-option - Dynamic options for declarative to evaluate at runtime
ruby-morpher - Data transformation algebra with optional tracked evaluation.
shake - Testing engine for the Lua language version 5.1
survivor - tool set for simulating/evaluating SVs
tarantool - In-memory database with a Lua application server
termit - Simple terminal emulator based on vte library, embedded lua
texlive-binaries - Binaries for TeX Live
texlive-luatex - TeX Live: LuaTeX packages
texworks-scripting-lua - Plugin to bring Lua scripting to TeXworks
uwsgi-plugin-lua5.1 - Lua WSAPI plugin for uWSGI (Lua 5.1)
uwsgi-plugin-lua5.2 - Lua WSAPI plugin for uWSGI (Lua 5.2)
uwsgi-plugin-luajit - Lua WSAPI plugin for uWSGI (LuaJIT)
vim-athena - Vi IMproved - enhanced vi editor - with Athena GUI
vim-gtk3 - Vi IMproved - enhanced vi editor - with GTK3 GUI
vim-nox - Vi IMproved - enhanced vi editor - with scripting languages support
weechat-lua - Fast, light and extensible chat client - Lua plugin
xavante - Lua HTTP 1.1 Web server
xorriso-dd-target - Device evaluator and disk image copier for GNU/Linux
