apt-cache search octave
cantor-backend-octave - Octave backend for Cantor
cauchy-dev - library for transforming Matlab/Octave files to C++
cauchy-tools - library for transforming Matlab/Octave files to C++ - toold
dh-octave - Debhelper-based infrastructure for building Octave add-on packages
dh-octave-autopkgtest - script for the automatic testing of Octave add-on packages
libcauchy0.0v5 - library for transforming Matlab/Octave files to C++
libcauchyxunit0.0v5 - library for transforming Matlab/Octave files to C++
libm2mml0.0v5 - library for transforming Matlab/Octave files to C++
liboctave-dev - transitional dummy package for GNU Octave development
libsbml5-octave - System Biology Markup Language library - Octave bindings
matlab2tikz - converter of Octave plots to TikZ figures (for integration into LaTeX)
mwrap - Octave/MATLAB mex generator
octave - GNU Octave language for numerical computations
octave-arduino - Octave Arduino Toolkit
octave-audio - MIDI functions for Octave
octave-bart - Octave bindings for BART
octave-bim - PDE solver using a finite element/volume approach in Octave
octave-biosig - Octave bindings for BioSig library
octave-brain2mesh - automated brain tetrahedral mesh generation toolbox for Octave
octave-bsltl - biospeckle laser tool library for Octave
octave-cgi - Common Gateway Interface for Octave
octave-common - architecture-independent files for octave
octave-communications - communications package for Octave
octave-communications-common - communications package for Octave (arch-indep files)
octave-control - computer-aided control system design (CACSD) for Octave
octave-data-smoothing - functions to do data smoothing on noisy data
octave-database - interface to SQL databases in Octave
octave-dataframe - manipulate data in Octave similar to R data.frame
octave-dev - development files for the GNU Octave language
octave-dicom - manipulate DICOM files in Octave
octave-divand - n-dimensional interpolation for Octave
octave-doc - documentation of the GNU Octave language
octave-doctest - documentation tests for Octave
octave-econometrics - econometrics functions for Octave
octave-financial - financial package for Octave
octave-fits - manipulation of FITS files in Octave
octave-fpl - plot data on unstructured triangular and tetrahedral meshes in Octave
octave-fuzzy-logic-toolkit - fuzzy logic toolkit for Octave
octave-ga - genetic optimization code for Octave
octave-gdf - IO library for the GDF -- Octave interface
octave-general - provide extra general functions for Octave
octave-geometry - extension of MatGeom functionality in Octave
octave-gsl - GSL binding for Octave
octave-image - image manipulation for Octave
octave-image-acquisition - image acquisition package for Octave
octave-instrument-control - instrument control for Octave
octave-interval - real-valued interval arithmetic for Octave
octave-interval-doc - real-valued interval arithmetic for Octave (arch-indep files)
octave-io - input/output data functions for Octave
octave-iso2mesh - 3D surface and volumetric mesh generator for Octave
octave-jnifti - fast NIfTI-1/2 reader and NIfTI-to-JNIfTI converter
octave-jsonlab - native JSON/UBJSON/MassagePack encoder/decoder for Octave
octave-level-set - level-set toolbox for Octave
octave-linear-algebra - additional linear-algebra functions for Octave
octave-lssa - least squares spectral analysis for Octave
octave-ltfat - Large Time/Frequency Analysis Toolbox
octave-ltfat-common - Large Time/Frequency Analysis Toolbox (arch-indep files)
octave-mapping - geographical mapping functions for Octave
octave-matgeom - computational geometry for Octave
octave-miscellaneous - miscellaneous tools for Octave
octave-missing-functions - finds functions that are in Matlab but not in Octave
octave-mpi - Octave toolbox for parallel computing using MPI
octave-msh - create and manage meshes for FE or FV solvers in Octave
octave-mvn - multivariate normal distribution clustering for Octave
octave-nan - handles data with and without missing values in Octave
octave-ncarray - access NetCDF files as a multi-dimensional array in Octave
octave-netcdf - Matlab compatible NetCDF interface for Octave
octave-nlopt - nonlinear optimization library -- GNU Octave package
octave-nurbs - non-uniform rational B-splines for Octave
octave-octclip - boolean operations with polygons in Octave
octave-octproj - GNU Octave bindings to PROJ.4
octave-openems - Octave interface for openems
octave-optics - optics functions for Octave
octave-optim - unconstrained non-linear optimization toolkit for Octave
octave-optiminterp - optimal interpolation package for Octave
octave-parallel - parallel execution of Octave in clusters of computers
octave-pfstools - octave bindings for pfstools
octave-phclab - general-purpose solver for polynomial systems (Octave)
octave-psychtoolbox-3 - toolbox for vision research -- Octave bindings
octave-quaternion - quaternion package for Octave
octave-queueing - Queueing Networks and Markov chains analysis for Octave
octave-secs1d - semi conductor simulator in 1D for Octave
octave-secs2d - semi conductor simulator in 2D for Octave
octave-secs3d - Drift-Diffusion simulator for 3d semiconductor devices in Octave
octave-signal - signal processing functions for Octave
octave-sockets - communication through Internet sockets in Octave
octave-sparsersb - RSB sparse matrix manipulation for Octave
octave-specfun - special mathematical functions for Octave
octave-splines - cubic spline functions for Octave
octave-statistics - additional statistical functions for Octave
octave-stk - (not so) Small Toolbox for Kriging
octave-strings - additional string manipulation functions for Octave
octave-struct - additional structure manipulation functions for Octave
octave-tsa - time series analysis in Octave
octave-vibes - VIBes API to easily display results in Octave
octave-video - video file reader/writer for Octave
octave-vlfeat - Computer vision library focussing on visual features and clustering
octave-vrml - VRML functions for Octave
octave-zenity - simple graphical user interfaces using zenity in Octave
octave-zeromq - ZeroMQ binding for Octave
octave-zmat - in-memory data compression for Octave
python3-octave-kernel - Jupyter kernel for Octave
sbmltoolbox - libsbml toolbox for octave and matlab
sdpam - Matlab/Octave interface of SDPA
