apt-cache search subversion
kdesvn - Subversion client with tight KDE integration
kdesvn-kio-plugins - Subversion I/O slaves for KDE
libapache2-mod-svn - Apache Subversion server modules for Apache httpd
libnb-svnclientadapter-java - High-level Java API to subversion
libnb-svnclientadapter-java-doc - High-level Java API to subversion javadoc
libsvn-class-perl - perl object oriented interface for Subversion workspaces
libsvn-dev - Development files for Apache Subversion libraries
libsvn-dump-perl - module for parsing Subversion dumps
libsvn-hooks-perl - framework for implementing Subversion hooks
libsvn-java - Java bindings for Apache Subversion
libsvn-notify-perl - Subversion activity notification
libsvn-perl - Perl bindings for Apache Subversion
libsvn-svnlook-perl - module to aid using svnlook in Subversion hooks
libsvn-web-perl - Subversion repository web frontend
libsvn1 - Shared libraries used by Apache Subversion
libsvnclientadapter-java - High-level Java API for Subversion (library)
libsvnclientadapter-java-doc - High-level Java API for Subversion (documentation)
libsvnkit-java - pure Java Subversion client library
lua-svn - Subversion library for the Lua language
lua-svn-dev - Development files for the Subversion library for the Lua language
nautilus-script-collection-svn - Nautilus subversion management scripts
python3-subversion - Python3 bindings for Apache Subversion
python3-subvertpy - Alternative Python bindings for Subversion - Python 3
python3-svn - A(nother) Python 3 interface to Subversion
ruby-svn - Ruby bindings for Apache Subversion
subversion - Advanced version control system
subversion-tools - Assorted tools related to Apache Subversion
svn-all-fast-export - fast-import based converter to convert repos from Subversion to git
svn-buildpackage - helper programs to maintain Debian packages with Subversion
svn-load - Enhanced import facility for Subversion
svn2cl - Generate a GNU-style ChangeLog from Subversion repository history
svnkit - pure Java Subversion client
tkcvs - Graphical front-end to CVS and Subversion
