apt-cache search uuid
libuuid-perl - Perl extension for using UUID interfaces as defined in e2fsprogs
libuuid1 - Universally Unique ID library
uuid-dev - Universally Unique ID library - headers and static libraries
uuid-runtime - runtime components for the Universally Unique ID library
cl-uuid - Common Lisp librabry for generation of UUIDs as described by RFC 4122
elpa-uuid - UUID/GUID library for Emacs Lisp
erlang-uuid - UUID generator for Erlang
golang-github-gofrs-uuid-dev - UUID library for Golang
golang-github-google-uuid-dev - generates and inspects UUIDs based on RFC 4122
golang-github-hashicorp-go-uuid-dev - generate UUID-format strings using high quality random bytes
golang-github-nu7hatch-gouuid-dev - pure Go UUID implementation as specified in RFC 4122
golang-github-pborman-uuid-dev - Go bindings to work with UUIDs
golang-github-rogpeppe-fastuuid-dev - fast generation of 192-bit UUIDs
golang-github-satori-go.uuid-dev - Go package for creating and parsing UUID
golang-github-twinj-uuid-dev - RFC 4122 and DCE 1.1 compliant UUIDs in Go
libcrossguid-dev - C++ UUID library headers
libcrossguid0 - C++ UUID library
libdata-uuid-libuuid-perl - uuid.h based UUID generation module
libdata-uuid-perl - globally/universally unique identifiers (GUIDs/UUIDs)
libdbix-class-uuidcolumns-perl - Implicit uuid columns
libghc-uuid-dev - create, compare, parse and print Universally Unique Identifiers
libghc-uuid-doc - create, compare, parse and print UUIDs; documentation
libghc-uuid-prof - create, compare, parse and print UUIDs; profiling libraries
libghc-uuid-types-dev - Type definitions for Universally Unique Identifiers
libghc-uuid-types-doc - Type definitions for Universally Unique Identifiers; documentation
libghc-uuid-types-prof - Type definitions for Universally Unique Identifiers; profiling libraries
libjug-java - Pure java UUID generator
libossp-uuid-dev - OSSP uuid ISO-C and C++ - headers and static libraries
libossp-uuid-perl - perl OSSP::UUID - OSSP uuid Perl Binding
libossp-uuid16 - OSSP uuid ISO-C and C++ - shared library
librust-core-foundation+uuid-dev - Bindings to Core Foundation for macOS - feature "uuid" and 1 more
librust-uuid+guid-dev - Generate and parse UUIDs - feature "guid" and 1 more
librust-uuid+md5-dev - Generate and parse UUIDs - feature "md5" and 1 more
librust-uuid+rand-dev - Generate and parse UUIDs - feature "rand" and 1 more
librust-uuid+serde-dev - Generate and parse UUIDs - feature "serde"
librust-uuid+sha1-dev - Generate and parse UUIDs - feature "sha1" and 1 more
librust-uuid+slog-dev - Generate and parse UUIDs - feature "slog"
librust-uuid-dev - Generate and parse UUIDs - Rust source code
libtypes-uuid-perl - type constraints for UUIDs
libuuid-tiny-perl - pure Perl module to generate v1, v3, v4, and v5 UUIDs
libuuid-urandom-perl - Perl module to provide UUIDs based on /dev/urandom
libuuidm-ocaml-dev - Universally unique identifiers for OCaml
node-uuid - simple and fast RFC4122 UUID generation - Node.js module
php-ramsey-uuid - RFC 4122 universally unique identifier (UUID) generator for PHP
php-symfony-polyfill-uuid - Symfony polyfill for uuid functions
php-uuid - PHP UUID extension
php-uuid-all-dev - PHP UUID extension
php8.1-uuid - PHP UUID extension
python3-django-shortuuidfield - Short UUIDField for Django for Python 3
python3-shortuuid - generates concise, unambiguous, URL-safe UUIDs for Python 3
python3-xstatic-angular-uuid - Angular UUID XStatic support
r-cran-uuid - Tools for generating and handling UUIDs
ruby-uuid - UUID generator for Ruby
ruby-uuidtools - UUIDs generation library for Ruby
ruby-uuidtools-doc - UUIDs generation library for Ruby - documentation
uuid - Universally Unique Identifier Command-Line Tool
uuidcdef - Universally Unique Identifier (UUID) generator
