apt-cache search vim
vim - Vi IMproved - enhanced vi editor
vim-common - Vi IMproved - Common files
vim-doc - Vi IMproved - HTML documentation
vim-runtime - Vi IMproved - Runtime files
vim-tiny - Vi IMproved - enhanced vi editor - compact version
apvlv - PDF viewer with Vim-like behaviour
biosyntax-vim - Syntax Highlighting for Computational Biology (vim)
cpl-plugin-vimos - ESO data reduction pipeline for the VIMOS instrument
cpl-plugin-vimos-calib - ESO data reduction pipeline calibration data downloader for VIMOS
cpl-plugin-vimos-doc - ESO data reduction pipeline documentation for VIMOS
cream - VIM macros that make the VIM easier to use for beginners
dh-vim-addon - debhelper addon to help package Vim/Neovim addons
elpa-neotree - directory tree sidebar for Emacs that is like NERDTree for Vim
elpa-powerline - Emacs version of the Vim powerline
elpa-vimish-fold - fold text in GNU Emacs like in Vim
geany-plugin-vimode - Vim-mode plugin for Geany
golang-github-reviewdog-errorformat-dev - Vim's quickfix errorformat implementation in Go (library)
golang-github-vimeo-go-magic-dev - Go bindings for libmagic
kakoune - Vim-inspired, selection-oriented code editor
libghc-yi-keymap-vim-dev - Vim keymap for Yi editor
libghc-yi-keymap-vim-doc - Vim keymap for Yi editor; documentation
libghc-yi-keymap-vim-prof - Vim keymap for Yi editor; profiling libraries
libocp-indent-ocaml - OCaml indentation tool for emacs and vim - libraries
libocp-indent-ocaml-dev - OCaml indentation tool for emacs and vim - development libraries
libvi-quickfix-perl - Perl support for vim's QuickFix mode
lua-nvim - Lua client for Neovim
lua-nvim-dev - Lua client for Neovim
neovim - heavily refactored vim fork
neovim-qt - neovim client library and GUI
neovim-runtime - heavily refactored vim fork (runtime files)
notmuch-vim - thread-based email index, search and tagging (vim interface)
ocp-indent - OCaml indentation tool for emacs and vim - runtime
pacvim - pacman game concept with vim command
python3-neovim - transitional dummy package
python3-pynvim - Python3 library for scripting Neovim processes through its msgpack-rpc API
qutebrowser - Keyboard-driven, vim-like browser based on PyQt5
r-cran-vim - GNU R visualization and imputation of missing values
ruby-neovim - Ruby client for Neovim
supercollider-vim - SuperCollider mode for Vim
svim - Structural variant caller for long sequencing reads
vim-addon-manager - manager of addons for the Vim editor
vim-addon-mw-utils - Vim funcref library
vim-airline - Lean & mean status/tabline for vim that's light as air
vim-airline-themes - official theme collection for vim-airline
vim-ale - Asynchronous Lint Engine for Vim 8 and NeoVim
vim-athena - Vi IMproved - enhanced vi editor - with Athena GUI
vim-autopep8 - vim plugin to apply autopep8
vim-bitbake - Vim plugin to interact with Yocto bitbake-based recipes
vim-command-t - open files with a minimum number of keystrokes
vim-ctrlp - fuzzy file, buffer, mru, tag, etc. finder for Vim
vim-editorconfig - EditorConfig Plugin for Vim
vim-fugitive - Vim plugin to work with Git
vim-git-hub - Vim runtime files for git-hub
vim-gitgutter - Vim plugin which shows a git diff in the sign column
vim-gtk - Vi IMproved - enhanced vi editor (dummy package)
vim-gtk3 - Vi IMproved - enhanced vi editor - with GTK3 GUI
vim-gui-common - Vi IMproved - Common GUI files
vim-haproxy - syntax highlighting for HAProxy configuration files
vim-icinga2 - syntax highlighting for Icinga 2 config files in VIM
vim-julia - Vim support for Julia language
vim-khuno - Python flakes Vim plugin
vim-lastplace - Vim script to reopen files at your last edit position
vim-latexsuite - view, edit and compile LaTeX documents from within Vim
vim-ledger - Vim plugin for Ledger
vim-migemo - VIM plugin for C/Migemo
vim-nox - Vi IMproved - enhanced vi editor - with scripting languages support
vim-pathogen - Manage your runtimepath with ease
vim-poke - Extensible editor for structured binary data (VIM addon)
vim-puppet - syntax highlighting for puppet manifests in vim
vim-python-jedi - autocompletion tool for Python - VIM addon files
vim-rails - vim development tools for Rails development
vim-redact-pass - stop pass(1) passwords ending up in Vim cache files
vim-scripts - plugins for vim, adding bells and whistles
vim-snipmate - Vim script that implements some of TextMate's snippets features.
vim-snippets - Snippets files for various programming languages.
vim-solarized - Solarized Colorscheme for Vim
vim-subtitles - Syntax highlighting for subtitle files
vim-syntastic - Syntax checking hacks for vim
vim-syntax-docker - Docker container engine - Vim highlighting syntax files
vim-syntax-gtk - Syntax files to highlight GTK+ keywords in vim
vim-tabular - Vim script for text filtering and alignment
vim-textobj-user - Vim plugin for user-defined text objects
vim-tjp - vim addon for TaskJuggler .tjp files
vim-tlib - Some vim utility functions
vim-ultisnips - snippet solution for Vim
vim-vader - simple vimscript test framework
vim-vimerl - Erlang plugin for Vim
vim-vimerl-syntax - Erlang syntax for Vim
vim-voom - Vim two-pane outliner
vim-youcompleteme - fast, as-you-type, fuzzy-search code completion engine for Vim
vis - Modern, legacy free, simple yet efficient vim-like editor
