apt-cache search nano
nano - small, friendly text editor inspired by Pico
deepnano - alternative basecaller for MinION reads of genomic sequences
deepnano-data - alternative basecaller for MinION reads of genomic sequences (data)
fast5 - utilities for manipulating Oxford Nanopore Fast5 files
libfast5-dev - library for reading Oxford Nanopore Fast5 files -- headers
libghc-nanospec-dev - lightweight implementation of a subset of Hspec's API
libghc-nanospec-doc - lightweight implementation of a subset of Hspec's API; documentation
libghc-nanospec-prof - lightweight implementation of a subset of Hspec's API; profiling libraries
libmrpt-nanogui-dev - Mobile Robot Programming Toolkit - nanogui development package
libmrpt-nanogui2.4 - Mobile Robot Programming Toolkit - nanogui library
libnanoflann-dev - C++11 header-only library for Nearest Neighbor Search with KD-Trees
libnanomsg-dev - nanomsg development files
libnanomsg-raw-perl - low-level interface to nanomsg for Perl
libnanomsg5 - high-performance implementation of scalability libraries
libnanopb-dev - Protocol Buffers with small code size, development files
libnanoxml2-java - Small XML parser for Java
libnanoxml2-java-doc - documentation for libnanoxml2-java
libtime-clock-perl - twenty-four hour clock object with nanosecond precision
mcaller - find methylation in nanopore reads
nano-tiny - small, friendly text editor inspired by Pico - tiny build
nanoc - static site generator written in Ruby
nanofilt - filtering and trimming of long read sequencing data
nanolyse - remove lambda phage reads from a fastq file
nanomsg-utils - nanomsg utilities
nanook - pre- and post-alignment analysis of nanopore sequencing data
nanook-examples - pre- and post-alignment analysis of nanopore sequencing data (examples)
nanopb - Protocol Buffers with small code size
nanopolish - consensus caller for nanopore sequencing data
nanostat - statistics on long biological sequences
nanosv - structural variant caller for nanopore data
node-postcss - Tool for transforming styles with JS plugins
openmx - package for nano-scale material simulations
openmx-data - package for nano-scale material simulations (data)
osmo-bsc-ipaccess-utils - Command line utilities for ip.access nanoBTS
picopore - lossless compression of Nanopore files
plasma-nano - Plasma shell for embedded devices
porechop - adapter trimmer for Oxford Nanopore reads
poretools - toolkit for nanopore nucleotide sequencing data
poretools-data - toolkit for nanopore nucleotide sequencing data -- sample datasets
python3-fast5 - library for reading Oxford Nanopore Fast5 files -- Python 3
python3-nanoget - extract information from Oxford Nanopore sequencing data and alignments
python3-nanoget-examples - example data for python3-nanoget (dealing with Oxford Nanopore data)
python3-nanomath - simple math function for other Oxford Nanopore processing scripts
python3-nanostat - statistics on long biological sequences
python3-pauvre - QC and genome browser plotting Oxford Nanopore and PacBio long reads
python3-picopore - lossless compression of Nanopore files (Python3 module)
python3-pychopper - identify, orient and trim full-length Nanopore cDNA reads
python3-shasta - nanopore whole genome assembly (dynamic library)
python3-shasta-doc - nanopore whole genome assembly (documentation)
qcat - demultiplexing Oxford Nanopore reads from FASTQ files
qcat-examples - demultiplexing Oxford Nanopore reads from FASTQ files (examples)
r-bioc-ioniser - Quality Assessment Tools for Oxford Nanopore MinION data
r-bioc-nanostringqcpro - processing and QA for NanoString mRNA expression data
r-cran-nanotime - GNU R package for nanosecond-resolution time support
r6rs-nanopass-dev - embedded DSL for writing compilers in Scheme
readucks - Nanopore read de-multiplexer (read demux -> readux -> readucks, innit)
ruby-nanoc-checking - static site generator written in Ruby - checker
ruby-nanoc-cli - static site generator written in Ruby - command line interface
ruby-nanoc-core - static site generator written in Ruby - core package
ruby-nanoc-deploying - static site generator written in Ruby - deployer
ruby-nanoc-external - static site generator written in Ruby - external filter
ruby-nanoc-live - static site generator written in Ruby - live support
ruby-nanotest - Exteremely minimal test framework
science-nanoscale-physics - Debian Science Nanoscale Physics packages
science-nanoscale-physics-dev - Debian Science Nanoscale Physics development packages
scrappie - basecaller for Nanopore sequencer
shasta - nanopore whole genome assembly (binaries and scripts)
tombo - identification of modified nucleotides from raw nanopore sequencing data
tombo-doc - identification of modified nucleotides from raw nanopore sequencing data (doc)
uncalled - Utility for Nanopore Current Alignment to Large Expanses of DNA
xpore - Nanopore analysis of differential RNA modifications
yanagiba - filter low quality Oxford Nanopore reads basecalled with Albacore
yanosim - read simulator nanopore DRS datasets
