apt-cache search patch
backuppc-rsync - patched rsync for BackupPC version 4
libegl-dev - Vendor neutral GL dispatch library -- EGL development files
libegl1 - Vendor neutral GL dispatch library -- EGL support
libgl-dev - Vendor neutral GL dispatch library -- GL development files
libgl1 - Vendor neutral GL dispatch library -- legacy GL support
libgles-dev - Vendor neutral GL dispatch library -- GLES development files
libgles1 - Vendor neutral GL dispatch library -- GLESv1 support
libgles2 - Vendor neutral GL dispatch library -- GLESv2 support
libglvnd-core-dev - Vendor neutral GL dispatch library -- core development files
libglvnd-dev - Vendor neutral GL dispatch library -- development files
libglvnd0 - Vendor neutral GL dispatch library
libglx-dev - Vendor neutral GL dispatch library -- GLX development files
libglx0 - Vendor neutral GL dispatch library -- GLX support
libopengl-dev - Vendor neutral GL dispatch library -- OpenGL development files
libopengl0 - Vendor neutral GL dispatch library -- OpenGL support
libspeechd-dev - Speech Dispatcher: Development libraries and header files
libspeechd2 - Speech Dispatcher: Shared libraries
linux-source - Linux kernel source with Ubuntu patches
linux-source-5.15.0 - Linux kernel source for version 5.15.0 with Ubuntu patches
networkd-dispatcher - Dispatcher service for systemd-networkd connection status changes
patch - Apply a diff file to an original
patchutils - Utilities to work with patches
python-pecan-doc - WSGI object-dispatching web framework
python-wrapt-doc - decorators, wrappers and monkey patching. - doc
python3-jsonpatch - library to apply JSON patches - Python 3.x
python3-pecan - WSGI object-dispatching web framework - Python 3.x
python3-singledispatch - single-dispatch generic functions for Python
python3-speechd - Python interface to Speech Dispatcher
python3-wrapt - decorators, wrappers and monkey patching. - Python 3.x
speech-dispatcher - Common interface to speech synthesizers
speech-dispatcher-audio-plugins - Speech Dispatcher: Audio output plugins
speech-dispatcher-espeak-ng - Speech Dispatcher: Espeak-ng output module
apksigcopier - copy/extract/patch android apk signatures & compare apks
audispd-plugins - Plugins for the audit event dispatcher
b4 - helper utility to work with patches made available via a public-inbox archive
backdoor-factory - Patch 32/64 bits ELF & win32/64 binaries with shellcode
bdfproxy - Patch binaries during download ala MITM
brltty-speechd - Access software for a blind person - Speech Dispatcher driver
bsdiff - generate/apply a patch between two binary files
cl-speech-dispatcher - Common Lisp interface to Speech Dispatcher
cl-webactions - HTTP dispatch library for cl-aserve
coccinelle - semantic patching tool for C
commit-patch - utility to commit fine grained patches to source code control repositories
cvsps - Tool to generate CVS patch set information
cyclist - Utility for converting Max/MSP binary patches to text
dc3dd - patched version of GNU dd with forensic features
debdelta - diff and patch utilities which work with Debian packages
debdelta-doc - diff and patch utilities which work with Debian packages
dpatch - patch maintenance system for Debian source packages
elpa-darcsum - pcl-cvs like interface for managing darcs patches
freepats - Free patch set for MIDI audio synthesis
git-publish - git command to prepare and store patch revisions as git tags
git-pw - tool for integrating Git with Patchwork
golang-github-docker-go-dev - Go packages with small patches autogenerated (used for canonical/json)
golang-github-evanphx-json-patch-dev - Go library to apply RFC6902 patches and create and apply RFC7386 patches
golang-github-gorilla-mux-dev - powerful URL router and dispatcher for golang
golang-github-gorilla-pat-dev - request router and dispatcher with a pat-like interface
golang-github-kr-binarydist-dev - Go implementation of the bspatch algorithm
golang-github-sergi-go-diff-dev - Diff, match and patch text in Go
haskell-aeson-diff-utils - extract and apply patches to JSON documents
kpatch - Runtime tools for Kpatch
kpatch-build - Build Tools for Kpatch and Livepatch
ld10k1 - ALSA emu10k1/2 patch loader
libapp-cli-perl - Dispatcher module for command line interface programs
libcatalyst-action-rest-perl - module for automatic REST method dispatching
libcatalyst-dispatchtype-regex-perl - Regex DispatchType for Catalyst
libcatalyst-plugin-log-dispatch-perl - Catalyst log module that uses Log::Dispatch
libcgi-application-dispatch-perl - request dispatcher for CGI::Application
libcgi-application-plugin-actiondispatch-perl - attribute extension for CGI::Application
libcgi-application-plugin-logdispatch-perl - plugin that adds Log::Dispatch support to CGI::Application
libcore-match-clojure - optimized pattern match and predicate dispatch library for Clojure
libdevel-patchperl-perl - Perl module to patch perl source ? la Devel::PPPort's buildperl.pl
libdiffutils-java - compute diffs and apply patches in Java
libdispatch-class-perl - dispatch on the type (class) of an argument
libdispatch-dev - development files for the Grand Central Dispatch API
libdispatch0 - user space implementation of the Grand Central Dispatch API
libex-monkeypatched-perl - experimental API for safe monkey-patching
libghc-aeson-diff-dev - extract and apply patches to JSON documents
libghc-aeson-diff-doc - extract and apply patches to JSON documents; documentation
libghc-aeson-diff-prof - extract and apply patches to JSON documents; profiling libraries
libgroove-dev - audio dispatching library (development files)
libhawtdispatch-java - libdispatch style API for Java and Scala
libinstpatch-1.0-2 - MIDI instrument editing library
libinstpatch-dev - MIDI instrument editing library development files
libkokyu-7.0.6 - ACE scheduling and dispatching library
libkokyu-dev - ACE scheduling and dispatching library - development files
liblo10k1-0 - ALSA emu10k1/2 patch-loader library
liblo10k1-dev - ALSA emu10k1/2 patch-loader library development files
liblog-any-adapter-dispatch-perl - adapter to use Log::Dispatch with Log::Any
liblog-dispatch-array-perl - module to log events to an array (reference)
liblog-dispatch-config-perl - Log4j for Perl
liblog-dispatch-configurator-any-perl - configurator implementation with Config::Any
liblog-dispatch-dir-perl - module to log messages to separate files in a directory
liblog-dispatch-filerotate-perl - Log to files that archive/rotate themselves
liblog-dispatch-filewriterotate-perl - module to log to files that archive/rotate themselves
liblog-dispatch-message-passing-perl - log events to Message::Passing
liblog-dispatch-perl - message dispatcher to multiple Log::Dispatch::* objects
liblog-dispatch-perl-perl - Use core Perl functions for logging with Log::Dispatch
liblog-dispatchouli-perl - simple wrapper around Log::Dispatch
liblombok-patcher-java - live-rewrite classes as a JVM runs
libmonkey-patch-action-perl - module to monkey-patching subs from other packages, with restore
libmonkey-patch-perl - scoped monkey-patching Perl module
libmoosex-multimethods-perl - Moose extension enabling multi method dispatch
libmoosex-types-varianttable-perl - Moose extension for a type-constraint based dispatch table
libpath-dispatcher-perl - flexible and extensible dispatcher module
libplexus-sec-dispatcher-java - Plexus Security Dispatcher Component used by Maven
libplexus-sec-dispatcher-java-doc - Documentation for Plexus Security Dispatcher Component
librust-bytecount-dev - Count bytes or UTF-8 codepoints in a byte slice - Rust source code
librust-dissimilar-dev - Diff library with semantic cleanup, based on Google's diff-match-patch - Rust source code
libsuper-perl - control superclass method dispatch
libtest-log-dispatch-perl - Log::Dispatch object to test what is being logged
libtext-patch-perl - module for patching text with a given patch
lua-copas - Copas is a dispatcher of concurrent TCP/IP requests
makepatch - generate/apply patch files with more functionality than plain diff
node-d3-dispatch - Register named callbacks and call them with arguments
panko-api - Event storage dispatcher for Ceilometer
patatt - utility for cryptographic attestation of patches sent via email
patchelf - modify properties of ELF executables
paxtest - Test suite for the PaX kernel patch
pd-iemguts - Pd-Objects for meta patching
php-patchwork-utf8 - UTF-8 strings handling for PHP
php-psr-event-dispatcher - Standard interfaces for event handling
php-symfony - set of reusable components and framework for web projects
php-symfony-event-dispatcher - dispatch events and listen to them
php-symfony-event-dispatcher-contracts - Generic abstractions related to dispatching event
puredata-import - Pd object for loading libraries within a patch
python-multipledispatch-doc - documentation for multipledispatch
python-panko-doc - Event storage dispatcher for Ceilometer. (common documentation)
python-pydispatch-doc - documentation for python3-pydispatch
python3-crank - dispatch mechanism for use across frameworks - Python 3.x
python3-diff-match-patch - robust algorithms for synchronizing plain text (Python 3 module)
python3-multipledispatch - multiple dispatch in Python
python3-nest-asyncio - Patch asyncio to allow nested event loops
python3-panko - Event storage dispatcher for Ceilometer (Python 3)
python3-patatt - library for cryptographic attestation of patches
python3-pydispatch - Python 3 signal dispatching mechanism
python3-typeshed - collection of library stubs for Python, with static types
python3-whatthepatch - Library for parsing patch files(Python 3)
quilt - Tool to work with series of patches
r-cran-patchwork - GNU R the composer of plots
ruby-diff-match-patch - diff/match/patch algorithms implemented in Ruby
ruby-hana - Implementation of JSON Patch and JSON Pointer RFC
ruby-open-uri-redirections - openuri patch to allow redirections between HTTP and HTTPS
ruby-rails-controller-testing - Extracting `assigns` and `assert_template` from ActionDispatch
speech-dispatcher-baratinoo - Speech Dispatcher: Baratinoo (VoxyGen) output module
speech-dispatcher-cicero - Speech Dispatcher: Cicero output module
speech-dispatcher-doc-cs - Speech Dispatcher documentation in Czech
speech-dispatcher-espeak - Speech Dispatcher: Espeak output module
speech-dispatcher-festival - Festival support for Speech Dispatcher
speech-dispatcher-flite - Speech Dispatcher: Flite output module
speech-dispatcher-kali - Speech Dispatcher: Kali output module
speechd-el - Emacs speech client using Speech Dispatcher
speechd-up - Interface between Speech Dispatcher and SpeakUp
splitpatch - split the patch up into files or hunks
stgit - manage stacks of patches in a git repository
topgit - a Git patch queue manager
wiggle - apply patches with conflicting changes
zeroc-icepatch2 - File distribution and patching
libmkl-core - Intel? MKL: Library dispatcher of Computational Layer
speech-dispatcher-ivona - Speech Dispatcher: Ivona output module
speech-dispatcher-pico - Speech Dispatcher: Pico output module
speech-dispatcher-rhvoice - RHVoice speech synthesizer - speech dispatcher module
speech-dispatcher-voxin - Speech Dispatcher: Voxin output module
