apt-cache search dialog
pinentry-curses - curses-based PIN or pass-phrase entry dialog for GnuPG
pinentry-gnome3 - GNOME 3 PIN or pass-phrase entry dialog for GnuPG
whiptail - Displays user-friendly dialog boxes from shell scripts
zenity - Display graphical dialog boxes from shell scripts
zenity-common - Display graphical dialog boxes from shell scripts (common files)
cairo-dock-dialog-rendering-plug-in - Dialog rendering plug-in for Cairo-dock
cpdb-backend-cups - Common Print Dialog Backends - CUPS/IPP Backend
cpdb-backend-file - Common Print Dialog Backends - Print-to-File Backend
cpdb-backend-gcp - Common Print Dialog Backends - Google Cloud Print Backend
dialog - Displays user-friendly dialog boxes from shell scripts
fillets-ng-data-cs - add-on sounds for Czech language spoken dialogs for fillets-ng
fillets-ng-data-nl - add-on sounds for Dutch language spoken dialogs for fillets-ng
gambas3-gb-form-dialog - Gambas native dialog form component
gnome-panel-control - command line utility to invoke GNOME panel run dialog/menu
grun - GTK+ based Run dialog
kdialog - Dialog display utility
knewstuff-dialog - Support for downloading application assets from the network.
krb5-auth-dialog - tray applet for reauthenticating kerberos tickets
liballegro-dialog5-dev - header files for the Allegro 5 dialog addon
liballegro-dialog5.2 - dialog addon for the Allegro 5 library
libcpdb-libs-backend-dev - Common Print Dialog Backends - Development files for Backend Library
libcpdb-libs-common-dev - Common Print Dialog Backends - Development files for both libraries
libcpdb-libs-common1 - Common Print Dialog Backends - Interface Library for Backends
libcpdb-libs-frontend-dev - Common Print Dialog Backends - Development files for Frontend Library
libcpdb-libs-frontend1 - Common Print Dialog Backends - Interface Library for Frontends
libeclipse-e4-ui-dialogs-java - Eclipse e4 dialogs
libjs-bootbox - flexible dialog boxes for Bootstrap
libmalcontent-ui-0-0 - library for parental control of applications - GTK+ widgets and dialogs
libqt6quickdialogs2-6 - Qt 6 Quick Dialogs 2 library
libqt6quickdialogs2quickimpl6 - Qt 6 Quick Dialogs 2 Quick Impl library
libqt6quickdialogs2utils6 - Qt 6 Quick Dialogs 2 Utils library
libt3widget2 - C++ terminal dialog toolkit
libtk-filedialog-perl - highly configurable file dialog widget for Perl/Tk
libtk-fontdialog-perl - font dialog widget for perl/Tk
libui-dialog-perl - UI::Dialog a wrapper for various dialog applications
lxqt-openssh-askpass - OpenSSH user/password GUI dialog for LXQt
nxdialog - Dialogs for NX Agent
pinentry-fltk - FLTK-based PIN or pass-phrase entry dialog for GnuPG
pinentry-gtk2 - GTK+-2-based PIN or pass-phrase entry dialog for GnuPG
pinentry-qt - Qt-based PIN or pass-phrase entry dialog for GnuPG
pinentry-x2go - OpenPGP (smart)card authentication dialog window for X2Go Client
polkit-kde-agent-1 - KDE dialogs for PolicyKit
python3-dialog - Python module for making simple terminal-based user interfaces
python3-editobj3 - automatic dialog box generator for Python objects (Python 3)
qml-module-qtquick-dialogs - Qt 5 Dialogs QML module
qml6-module-qtquick-dialogs - Qt 6 Quick Dialogs QML module
rofi - window switcher, run dialog and dmenu replacement
tk-fsdialog - file selection dialog for Ttk
yad - tool for creating graphical dialogs from shell scripts
