apt-cache search ftp
dnsmasq-base - Small caching DNS proxy and DHCP/TFTP server
erlang-ftp - Erlang/OTP FTP client
erlang-tftp - Erlang/OTP TFTP client and server
ftp - dummy transitional package for tnftp
lftp - Sophisticated command-line FTP/HTTP/BitTorrent client programs
libruby3.0 - Libraries necessary to run Ruby 3.0
openssh-sftp-server - secure shell (SSH) sftp server module, for SFTP access from remote machines
php8.1-common - documentation, examples and common module for PHP
python3-txtftp - Twisted-based TFTP implementation
tftp-hpa - HPA's tftp client
tftp-hpa-dbg - HPA's tftp (debug)
tftpd-hpa - HPA's tftp server
tnftp - enhanced ftp client
vsftpd - lightweight, efficient FTP server written for security
vsftpd-dbg - lightweight, efficient FTP server written for security (debug)
argonaut-fuse - Argonaut (modular TFTP/Fuse supplicant)
argonaut-fuse-module-fai - Argonaut (LDAP FAI module for the TFTP/Fuse supplicant)
argonaut-fuse-module-opsi - Argonaut (OPSI module for the TFTP/Fuse supplicant)
atftp - advanced TFTP client
atftpd - advanced TFTP server
cl-ftp - Common Lisp FTP library
curlftpfs - filesystem to access FTP hosts based on FUSE and cURL
debmirror - Debian partial mirror script, with ftp and package pool support
dnsmasq - Small caching DNS proxy and DHCP/TFTP server
dnsmasq-base-lua - Small caching DNS proxy and DHCP/TFTP server
filezilla - Full-featured graphical FTP/FTPS/SFTP client
ftp-proxy - application level proxy for the FTP protocol
ftp-proxy-doc - documentation for ftp-proxy
ftp-ssl - FTP client with SSL or TLS encryption support
ftp-upload - put files with FTP from a script
ftp.app - File transfer protocol application for GNUstep
ftpcopy - FTP clients collection
ftpd - File Transfer Protocol (FTP) server
ftpd-ssl - FTP server with SSL encryption support
ftpgrab - file mirroring utility
ftpmirror - Mirroring directory hierarchy using FTP protocol
ftpsync - Debian archive mirror tool
ftpwatch - Notifies you of changes on remote ftp servers
fusiondirectory-plugin-pureftpd - pureftpd plugin for FusionDirectory
fusiondirectory-plugin-pureftpd-schema - LDAP schema for FusionDirectory pureftpd plugin
gajim-plugininstaller - Gajim plugin to install plugins from ftp.gajim.org
gesftpserver - sftp server submodule for OpenSSH
gfal2-plugin-gridftp - Provides the gridftp support for gfal2
gfal2-plugin-sftp - Provides sftp support for gfal2
gftp - X/GTK+ and console FTP client (metapackage)
gftp-common - shared files for other gFTP packages
gftp-gtk - X/GTK+ FTP client
gftp-text - colored FTP client using GLib
git-ftp - Git powered FTP client written as shell script
globus-gridftp-server-progs - Grid Community Toolkit - Globus GridFTP Server Programs
golang-github-jlaffaye-ftp-dev - FTP client package for Go
golang-github-pin-tftp-dev - TFTP server and client library for Golang (library)
golang-github-pkg-sftp-dev - SFTP support for the golang.org/x/crypto/ssh package
golang-github-smira-go-ftp-protocol-dev - plugin for http.Transport with support for ftp:// protocol
gosa-plugin-pureftpd - pureftpd plugin for GOsa?
gosa-plugin-pureftpd-schema - LDAP schema for GOsa? pureftpd plugin
inetutils-ftp - File Transfer Protocol client
inetutils-ftpd - File Transfer Protocol server
jftp - Java GUI client for FTP, SMB, SFTP and NFS
jmeter-ftp - Load testing and performance measurement application (ftp module)
kodi-vfs-sftp - SSH File Transfer Protocol for Kodi
libftp-dev - Library of callable ftp routines (development)
libftp4 - Library of callable ftp routines
libglobus-ftp-client-dev - Grid Community Toolkit - GridFTP Client Library Development Files
libglobus-ftp-client-doc - Grid Community Toolkit - GridFTP Client Library Documentation Files
libglobus-ftp-client2 - Grid Community Toolkit - GridFTP Client Library
libglobus-ftp-control-dev - Grid Community Toolkit - GridFTP Control Library Development Files
libglobus-ftp-control-doc - Grid Community Toolkit - GridFTP Control Library Documentation Files
libglobus-ftp-control1 - Grid Community Toolkit - GridFTP Control Library
libglobus-gridftp-server-control-dev - Grid Community Toolkit - Globus GridFTP Server Library Development Files
libglobus-gridftp-server-control0 - Grid Community Toolkit - Globus GridFTP Server Library
libglobus-gridftp-server-dev - Grid Community Toolkit - Globus GridFTP Server Development Files
libglobus-gridftp-server6 - Grid Community Toolkit - Globus GridFTP Server
libglobus-xio-gridftp-driver - Grid Community Toolkit - Globus XIO GridFTP Driver
libglobus-xio-gridftp-driver-dev - Grid Community Toolkit - Globus XIO GridFTP Driver Development Files
libglobus-xio-gridftp-driver-doc - Grid Community Toolkit - Globus XIO GridFTP Driver Documentation Files
libglobus-xio-gridftp-multicast - Grid Community Toolkit - Globus XIO GridFTP Multicast Driver
libglobus-xio-gridftp-multicast-dev - Grid Community Toolkit - Globus XIO GridFTP Multicast Driver Development Files
libio-all-lwp-perl - Perl module to use HTTP and FTP URLs with IO::All
libjglobus-gridftp-java - Globus Java - GridFTP
libnet-sftp-foreign-perl - client for the Secure File Transfer Protocol
libnet-sftp-sftpserver-perl - Secure File Transfer Protocol Server
libnet-tftp-perl - Perl module for accessing TFTP servers
libnet-tftpd-perl - Perl extension for Trivial File Transfer Protocol Server
libobexftp-perl - perl binding to the object exchange file transfer library
libobexftp0 - object exchange file transfer library
libobexftp0-dev - object exchange file transfer library - development files
librust-curl-sys-dev - Native bindings to the libcurl library - Rust source code
librust-winapi-dev - Raw FFI bindings for all of Windows API - Rust source code
libwagon-ftp-java - Artifact transport abstraction used in Maven (FTP provider)
linphone - SIP softphone - graphical client (transitional package)
linphone-cli - SIP softphone - console-only client
linphone-common - Shared components of the linphone SIP softphone
linphone-desktop - SIP softphone - graphical client
linphone-nogtk - SIP softphone - console-only client (transitional package)
mysecureshell - SFTP Server with ACL
mysqmail-pure-ftpd-logger - real-time logging system in MySQL - Pure-FTPd traffic-logger
ncftp - User-friendly and well-featured FTP client
nordugrid-arc-gridftpd - ARC GridFTP server
nordugrid-arc-plugins-gridftp - ARC Globus dependent DMCs
nordugrid-arc-plugins-gridftpjob - ARC GRIDFTPJOB client plugin
obexfs - mount filesystem of ObexFTP capable devices
obexftp - file transfer utility for devices that use the OBEX protocol
owftpd - FTP daemon providing access to 1-Wire networks
php-net-ftp - Net_FTP provides an OO interface to the PHP FTP functions plus some additions
php-seclib - implementations of an arbitrary-precision integer arithmetic library
proftpd-basic - Transitional dummy package for ProFTPD
proftpd-core - Versatile, virtual-hosting FTP daemon - binaries
proftpd-dev - Versatile, virtual-hosting FTP daemon - development files
proftpd-doc - Versatile, virtual-hosting FTP daemon - documentation
proftpd-mod-autohost - ProFTPD module mod_autohost
proftpd-mod-case - ProFTPD module mod_case
proftpd-mod-clamav - ProFTPD module mod_clamav
proftpd-mod-counter - ProFTPD module mod_counter
proftpd-mod-crypto - Versatile, virtual-hosting FTP daemon - TLS/SSL/SFTP modules
proftpd-mod-fsync - ProFTPD module mod_fsync
proftpd-mod-geoip - Versatile, virtual-hosting FTP daemon - GeoIP module
proftpd-mod-geoip2 - ProFTPD module mod_geoip2
proftpd-mod-ldap - Versatile, virtual-hosting FTP daemon - LDAP module
proftpd-mod-msg - ProFTPD module mod_msg
proftpd-mod-mysql - Versatile, virtual-hosting FTP daemon - MySQL module
proftpd-mod-odbc - Versatile, virtual-hosting FTP daemon - ODBC module
proftpd-mod-pgsql - Versatile, virtual-hosting FTP daemon - PostgreSQL module
proftpd-mod-proxy - ProFTPD module mod_proxy
proftpd-mod-snmp - Versatile, virtual-hosting FTP daemon - SNMP module
proftpd-mod-sqlite - Versatile, virtual-hosting FTP daemon - SQLite3 module
proftpd-mod-statsd - ProFTPD module mod_statsd
proftpd-mod-tar - ProFTPD module mod_tar
proftpd-mod-vroot - ProFTPD module mod_vroot
proftpd-mod-wrap - Versatile, virtual-hosting FTP daemon - tcpwrapper module
puppet-module-debian-archvsync - Puppet module for maintaining a Debian FTP mirror
puppet-module-puppetlabs-tftp - Puppet module for managing tftp-hpa
pure-ftpd - Secure and efficient FTP server
pure-ftpd-common - Pure-FTPd FTP server (Common Files)
pure-ftpd-ldap - Secure and efficient FTP server with LDAP user authentication
pure-ftpd-mysql - Secure and efficient FTP server with MySQL user authentication
pure-ftpd-postgresql - Secure and efficient FTP server with PostgreSQL user authentication
pureadmin - Gtk graphic front-end for PureFTPd
putty-tools - command-line tools for SSH, SCP, and SFTP
python-aioftp-doc - FTP client and server for asyncio (common documentation)
python-pyftpdlib-doc - documentation for Python FTP server library
python3-aioftp - FTP client and server for asyncio (Python 3)
python3-django-storages-ftp - storage backends in Django (FTP)
python3-django-storages-sftp - storage backends in Django (SFTP)
python3-fbtftp - Framework to build dynamic TFTP servers (Python3)
python3-ftputil - high-level FTP client library for Python
python3-minecraftpi - Raspberry PI Minecraft API Python client library
python3-parfive - HTTP and FTP parallel file downloader for Python
python3-pyftpdlib - Python FTP server library (Python 3)
python3-thriftpy - Pure Python implementation of Apache Thrift
python3-typeshed - collection of library stubs for Python, with static types
r-cran-rcurl - GNU R General network (HTTP/FTP/...) client interface
ruby-net-sftp - Ruby implementation of the SFTP protocol
ruby-obexftp - ruby binding to the object exchange file transfer library
sitecopy - program for managing a WWW site via FTP, SFTP, DAV or HTTP
slang-curl - transfer files using HTTP and FTP from S-Lang
tftp - Trivial file transfer protocol client
tftpd - Trivial file transfer protocol server
twoftpd - a simple secure efficient FTP server (programs)
twoftpd-run - a simple secure efficient FTP server
uftp - Encrypted multicast file transfer program
webdeploy - Deploy files using FTP
weex - Non-interactive FTP and FTPS client for updating web pages
wput - tiny wget-like ftp-client for uploading files
yafc - yet another FTP client
publicfile-installer - installer package for the publicfile HTTP and FTP server
