apt-cache search gdb
crash - kernel debugging utility, allowing gdb like syntax
gdb - GNU Debugger
gdb-doc - The GNU Debugger Documentation
libcc1-0 - GCC cc1 plugin for GDB
libgdbm-compat-dev - GNU dbm database routines (legacy support development files)
libgdbm-compat4 - GNU dbm database routines (legacy support runtime version)
libgdbm-dev - GNU dbm database routines (development files)
libgdbm6 - GNU dbm database routines (runtime version)
libruby3.0 - Libraries necessary to run Ruby 3.0
python3-gdbm - GNU dbm database support for Python 3.x
python3-gdbm-dbg - GNU dbm database support for Python 3.x (debug extension)
wireless-regdb - wireless regulatory database
avarice - use GDB with Atmel AVR debuggers
cgdb - curses-based interface to the GNU Debugger (GDB)
clisp-module-gdbm - GNU CLISP module that adds an interface to GNU DBM
gauche-gdbm - gdbm binding for Gauche
gdb-avr - GNU Debugger for avr
gdb-bpf - Cross-debugger for the bpf target
gdb-mingw-w64 - Cross-debugger for Win32 and Win64 using MinGW-w64
gdb-mingw-w64-target - Cross-debugger server for Win32 and Win64 using MinGW-w64
gdb-msp430 - The GNU debugger for MSP430
gdb-multiarch - GNU Debugger (with support for multiple architectures)
gdb-source - GNU Debugger (source)
gdbm-l10n - GNU dbm database routines (translation files)
gdbmtool - GNU dbm database routines (command line tools)
gdbserver - GNU Debugger (remote server)
geany-plugin-scope - graphical GDB front-end for Geany
golang-github-gmazoyer-peeringdb-dev - PeeringDB API package for Go
libdevel-gdb-perl - module to open and communicate with a gdb session
libgdbm-gst - GDBM bindings for GNU Smalltalk
libgdbussyncevo0 - Sync personal information data via SyncML/CalDAV/CardDAV (shared gdbus library)
libqdbm14 - QDBM Database Libraries without GDBM wrapper[runtime]
libruby2.7 - Libraries necessary to run Ruby 2.7
libwgdb-dev - lightweight NoSQL database library, development files
libwgdb0 - lightweight NoSQL database library, shared library
lmicdiusb - Remote GDB socket over USB for Stellaris Launchpad ICDI
lx-gdb - Dump and load databases from HP 100LX/200LX palmtops
pgdbf - converter of XBase / FoxPro tables to PostgreSQL
python-gdbm - GNU dbm database support for Python2
python-gdbm-dbg - GNU dbm database support for Python2 (debug extension)
r-bioc-stringdb - Search Tool for the Retrieval of Interacting proteins database
rust-gdb - Rust debugger (gdb)
slang-gdbm - access to GDBM databases from S-Lang
nvidia-cuda-gdb - NVIDIA CUDA Debugger (GDB)
tiemu - Texas Instruments calculators emulator (without GDB)
