apt-cache search graphviz
codecgraph - Generates graphviz graphs from HDA-Intel codec information
dot2tex - Graphviz to LaTeX converter
dothost - simple DNS lookup network utility, produces output in Graphviz format
elpa-graphviz-dot-mode - Emacs mode for the dot-language used by graphviz.
golang-github-awalterschulze-gographviz-dev - Graphviz DOT language in golang
graphviz - rich set of graph drawing tools
graphviz-doc - additional documentation for graphviz
libdeps-renderer-dot-perl - DEPS renderer plugin using GraphViz/dot
libghc-graphviz-dev - bindings to Graphviz for graph visualization
libghc-graphviz-doc - bindings to Graphviz for graph visualization; documentation
libghc-graphviz-prof - bindings to Graphviz for graph visualization; profiling libraries
libgraph-easy-perl - Perl module to convert or render graphs (as ASCII, HTML, SVG or via Graphviz)
libgraph-writer-graphviz-perl - GraphViz Writer for Graph object
libgraphviz-dev - graphviz libs and headers against which to build applications
libgraphviz-perl - Perl interface to the GraphViz graphing tool
libgv-guile - Guile bindings for graphviz
libgv-lua - Lua bindings for graphviz
libgv-perl - Perl bindings for graphviz
libgv-ruby - Ruby bindings for graphviz
libgv-tcl - Tcl bindings for graphviz
python-pydotplus-doc - interface to Graphviz's Dot language - doc
python-pygraphviz-doc - Python interface to the Graphviz graph layout and visualization package (doc)
python3-graphviz - Simple Python 3 interface for Graphviz
python3-gv - Python3 bindings for graphviz
python3-pydot - Python interface to Graphviz's dot (Python 3)
python3-pydotplus - interface to Graphviz's Dot language - Python 3.x
python3-pygraphviz - Python interface to the Graphviz graph layout and visualization package (Python 3)
ruby-graphviz - Ruby interface to the GraphViz graphing tool
xdot - interactive viewer for Graphviz dot files
