apt-cache search tcl
blt - graphics extension library for Tcl/Tk - run-time
blt-dev - graphics extension library for Tcl/Tk - development files
libnutclient-dev - network UPS tools - development files for the new client library
libnutclient0 - network UPS tools - new client library
libtcl8.6 - Tcl (the Tool Command Language) v8.6 - run-time library files
libtk8.6 - Tk toolkit for Tcl and X11 v8.6 - run-time files
postgresql-pltcl-14 - PL/Tcl procedural language for PostgreSQL 14
python-swiftclient-doc - Client library for Openstack Swift API - doc
python3-heatclient - client library and CLI for OpenStack Heat - Python 3.x
python3-swiftclient - Client library for Openstack Swift API - Python 3.x
targetcli-fb - Command shell for managing the Linux LIO kernel target
tcl - Tool Command Language (default version) - shell
tcl-dev - Tool Command Language (default version) - development files
tcl-doc - Tool Command Language (default version) - manual pages
tcl8.6 - Tcl (the Tool Command Language) v8.6 - shell
tcl8.6-dev - Tcl (the Tool Command Language) v8.6 - development files
tcl8.6-doc - Tcl (the Tool Command Language) v8.6 - manual pages
tk - Toolkit for Tcl and X11 (default version) - windowing shell
tk-dev - Toolkit for Tcl and X11 (default version) - development files
tk-doc - Toolkit for Tcl and X11 (default version) - manual pages
tk8.6 - Tk toolkit for Tcl and X11 v8.6 - windowing shell
tk8.6-blt2.5 - graphics extension library for Tcl/Tk - library
tk8.6-dev - Tk toolkit for Tcl and X11 v8.6 - development files
tk8.6-doc - Tk toolkit for Tcl and X11 v8.6 - manual pages
astro-tcltk - Tcl/Tk packages for astronomy
blt-demo - graphics extension library for Tcl/Tk - demos and examples
bwidget - Extension widgets for Tcl/Tk
caja-nextcloud - Nextcloud integration for Caja
chiark-tcl-applet - Tray widget for battery monitor and other X11 programs
critcl - compiled runtime in Tcl
dolphin-nextcloud - Nextcloud integration for Dolphin
ewipe - Yet another presentation tool based on Tcl/Tk
gocr-tk - tcl/tk wrapper around gocr
golang-github-lunixbochs-vtclean-dev - strips terminal escapes from text, can preserve color
gpsmanshp - Tcl interface to shapelib
hfsutils-tcltk - Tcl/Tk interfaces for reading and writing Macintosh volumes
itcl3 - [incr Tcl] OOP extension for Tcl - run-time files
itcl3-dev - [incr Tcl] OOP extension for Tcl - development files
itcl3-doc - [incr Tcl] OOP extension for Tcl - manual pages
jimsh - small-footprint implementation of Tcl named Jim
kodi-eventclients-common - Open Source Home Theatre (Event Client Common package)
kodi-eventclients-dev - Open Source Home Theatre (Event Client Dev package)
kodi-eventclients-kodi-send - Open Source Home Theatre (Event Client Kodi-SEND package)
kodi-eventclients-ps3 - Open Source Home Theatre (Event Client PS3 package)
kodi-eventclients-wiiremote - Open Source Home Theatre (Event Client WII Remote support package)
kodi-eventclients-zeroconf - Open Source Home Theatre (Event Client ZeroConf script package)
kwalletcli - command line interface to the KDE Wallet
labltk - OCaml bindings to Tcl/Tk (executables)
libapache2-mod-rivet - Server-side Tcl programming system combining ease of use and power
libapache2-mod-rivet-doc - Documentation for Rivet, a server-side Tcl programming system
libbusiness-onlinepayment-tclink-perl - TrustCommerce backend for Business::OnlinePayment
libdb5.3-tcl - Berkeley v5.3 Database Libraries for Tcl [module]
libfungw-tcl1 - Scripting support for fungw: tcl
libgv-tcl - Tcl bindings for graphviz
libhamlib2-tcl - Transitional package depending on tcl-hamlib
libidzebra-2.0-mod-grs-regx - IDZebra 'grs.regx' and 'grs.tcl' filters
libjim-dev - small-footprint implementation of Tcl - development files
libjim0.79 - small-footprint implementation of Tcl - shared library
liblabltk-ocaml - OCaml bindings to Tcl/Tk (runtime libraries)
liblabltk-ocaml-dev - OCaml bindings to Tcl/Tk (dev. libraries)
libmrpt-tclap-dev - Mobile Robot Programming Toolkit - tclap development package
libnet-tclink-perl - Perl interface to the TrustCommerce payment gateway
libnetclasses-dev - Objective-C framework for socket programming with GNUstep (devel)
libnetclasses0 - Objective-C framework for socket programming with GNUstep (libs)
libnextcloudsync-dev - Nextcloud folder synchronization - development files
libnextcloudsync0 - Nextcloud folder synchronization - libraries
libocamlnet-ocaml-dev - OCaml application-level Internet libraries - core development libraries
libopenni-sensor-pointclouds-dev - headers for Kinect sensor modules for the OpenNI framework
libopenni-sensor-pointclouds0 - Microsoft Kinect sensor modules for the OpenNI framework
libotcl1 - shared library of OTcl
libotcl1-dev - static library of OTcl
libow-tcl - Dallas 1-wire support: Tcl bindings
libpdal-plugin-pgpointcloud - Point Data Abstraction Library - PostgreSQL PointCloud plugin
libpgtcl - Tcl client library binding for PostgreSQL
libpgtcl-dev - Tcl client library binding for PostgreSQL - development files
libsnack-alsa - Sound extension to Tcl/Tk and Python/Tkinter - ALSA files
libsnack-oss - Sound extension to Tcl/Tk and Python/Tkinter - OSS files
libsqlite-tcl - SQLite 2 Tcl bindings
libsqlite3-tcl - SQLite 3 Tcl bindings
libtcl-chiark-1 - Tcl interfaces for adns, cdb, crypto, etc.
libtcl-perl - Tcl extension module for Perl
libtclap-dev - Templatized command-line argument parser for C++
libtclcl1 - shared library of TclCL
libtclcl1-dev - development files of TclCL
libtk-img - Extended image format support for Tcl/Tk (runtime)
libtk-img-dev - Extended image format support for Tcl/Tk (development files)
libtk-img-doc - Extended image format support for Tcl/Tk (manual pages)
libukui-fontclient-dev - font settings interfaces
libukui-fontclient0 - font settings module
msort-gui - tcl/tk gui for msort utility
mysqltcl - interface to the MySQL database for the Tcl language
nautilus-nextcloud - Nextcloud integration for Nautilus
nbdkit-plugin-tcl - TCL plugin for nbdkit
nemo-nextcloud - Nextcloud integration for Nemo
newt-tcl - NEWT module for Tcl
nextcloud-desktop - Nextcloud folder synchronization tool
nextcloud-desktop-cmd - folder synchronization with an Nextcloud server - cmd client
nextcloud-desktop-common - Nextcloud folder synchronization - common data
nextcloud-desktop-doc - Nextcloud folder synchronization - documentation
nextcloud-desktop-l10n - Nextcloud folder synchronization - localization
ngspice-dev - Spice circuit simulator - development files for ngspice and tclspice
nsf - Next Scripting Framework (NSF): Object orientation for Tcl - shared library
nsf-dev - Next Scripting Framework (NSF): Object orientation for Tcl - development files
nsf-shells - Next Scripting Framework (NSF): Object orientation for Tcl - shells
octave-octclip - boolean operations with polygons in Octave
otcl-shells - OTcl shells
partclone - Utility to clone and restore a partition
pd-rtclib - Real Time Composition Library for Pure Data (Pd)
pd-tclpd - Tcl objects for Pure Data (Pd)
pfm - PostgreSQL graphical client using Tcl/Tk
plplot-tcl - Tcl/Tk support for PLplot, a plotting library
plplot-tcl-bin - Tcl/Tk tools for PLplot, a plotting library
plplot-tcl-dev - Tcl/Tk development support for PLplot, a plotting library
postgresql-14-pointcloud - PostgreSQL extension for storing point cloud (LIDAR) data
prometheus-nextcloud-exporter - Prometheus exporter for Nextcloud server metrics
python-searchlightclient-doc - OpenStack Indexing and Search API Client Library - doc
python3-fastcluster - Fast hierarchical clustering routines for Python 3
python3-pcl - Python 3 binding to the Pointcloud library (PCL)
python3-searchlightclient - OpenStack Indexing and Search API Client Library - Python 3.x
python3-tksnack - Sound extension to Tcl/Tk and Python/Tkinter - Python 3.x library
r-cran-fastcluster - Fast hierarchical clustering routines for GNU R
r-cran-gwidgetstcltk - Toolkit implementation of gWidgets for tcltk package
r-cran-tcltk2 - GNU R package for Tcl/Tk additions
rnetclient - Send the Brazilian Income Tax Report to the Brazilian Tax Authority
rrdtool-tcl - time-series data storage and display system (Tcl interface)
tcl-awthemes - Dark and light themes for Tk
tcl-combat - CORBA scripting with Tcl
tcl-expect - Automates interactive applications (Tcl package)
tcl-expect-dev - Automates interactive applications (development)
tcl-fitstcl - Tcl interface to FITS files
tcl-funtools - Minimal buy-in FITS library (Tcl interface)
tcl-hamlib - Run-time Tcl library to control radio transceivers and receivers
tcl-itcl4 - [incr Tcl] OOP extension for Tcl - run-time files
tcl-itcl4-dev - [incr Tcl] OOP extension for Tcl - development files
tcl-itcl4-doc - [incr Tcl] OOP extension for Tcl - manual pages
tcl-memchan - Tcl extension for in-memory channels - runtime library
tcl-memchan-dev - Tcl extension for in-memory channels - development files
tcl-signal - "Signal" extension for Tcl
tcl-snack - Sound extension to Tcl/Tk and Python/Tkinter - Tcl/Tk library
tcl-snack-dev - Sound extension to Tcl/Tk and Python/Tkinter - development files
tcl-snack-doc - Sound extension to Tcl/Tk and Python/Tkinter - documentation
tcl-sugar - Lisp-like macro system for Tcl
tcl-tclex - Lexical analyzer generator for Tcl
tcl-tclreadline - GNU Readline Extension for Tcl/Tk
tcl-thread - Tcl extension implementing script level access to Tcl threading capabilities
tcl-tls - TLS OpenSSL extension to Tcl
tcl-trf - Tcl data transformations - runtime library
tcl-trf-dev - Tcl data transformations - development files
tcl-trf-doc - Tcl data transformations - documentation
tcl-ttkthemes - Themes for the ttk extensions for Tkinter
tcl-udp - UDP sockets for Tcl
tcl-vfs - Exposes Tcl's virtual filesystem C API to the Tcl script level
tcl-vtk7 - Tcl bindings for VTK
tcl-xmlrpc - XML-RPC implementation for Tcl
tcl-xpa - Seamless communication between Unix programs (Tcl interface)
tcl-yajltcl - Tcl binding to libyajl, a JSON parser and generator
tcl3270 - Program for Tcl-scripted telnet sessions to IBM mainframes
tcl8.6-tdbc - Tcl Database Connectivity
tcl8.6-tdbc-mysql - Tcl Database Connectivity
tcl8.6-tdbc-odbc - ODBC driver for the Tcl Database Connectivity
tcl8.6-tdbc-postgres - Tcl Database Connectivity
tcl8.6-tdbc-sqlite3 - Tcl Database Connectivity
tclcl - tcl2c++ and otcldoc program from tclcl
tclcl-dbg - debug symbols of TclCL: both tclcl and libtclcl1
tclcl-dev - transitional dummy package to libtclcl-dev
tclcurl - Tcl bindings to libcurl
tclfitsy - Tcl FITS Extension
tclgeoip - Tcl extension implementing GeoIP lookup functions
tcliis - Tcl IIS protocol package
tcllib - Standard Tcl Library
tcllib-critcl - Standard Tcl Library (CriTcl accelerators)
tclodbc - ODBC extension for Tcl
tclsoldout - Tcl wrapper for libsoldout, a markdown parser library
tclspice - NGSpice library for Tcl
tclws - Tcl Web Services
tclx8.4 - Extended Tcl (TclX) - shared library
tclx8.4-dev - Extended Tcl (TclX) - development package
tclx8.4-doc - Extended Tcl (TclX) - manpages
tclxapian - Xapian search engine interface for Tcl
tclxml - Tcl library for XML parsing
tclxml-dev - Tcl library for XML parsing - development files
tdom - fast XML/DOM/XPath/XSLT/HTML/JSON extension for Tcl written in C
tk-table - Table extension for Tcl/Tk
tk-tktray - Freedesktop system tray icon support for Tcl/Tk on X11
tkblt - Graphics extension library for Tcl/Tk
tkblt-dev - Graphics extension library for Tcl/Tk (development files)
tkcon - Enhanced interactive console for developing in Tcl
tkdesk - Tk/tcl based X11 Desktop/File manager
tkgate - Tcl/Tk based digital circuit editor and simulator
tkgate-data - Tcl/Tk based digital circuit editor and simulator - data files
tkgate-doc - Tcl/Tk based digital circuit editor and simulator - documentation
tkinfo - Tcl/Tk Info browser
tkinspect - Tk application inspector for developing in Tcl
tkpng - PNG photo image support to Tcl/Tk
tktreectrl - flexible listbox widget for Tcl/Tk
vim-athena - Vi IMproved - enhanced vi editor - with Athena GUI
vim-gtk3 - Vi IMproved - enhanced vi editor - with GTK3 GUI
vim-nox - Vi IMproved - enhanced vi editor - with scripting languages support
weechat-tcl - Fast, light and extensible chat client - Tcl plugin
xhtml2ps - HTML to PostScript converter (Tcl/Tk GUI frontend)
xorriso-tcltk - educational GUI frontend for ISO-9660 manipulation tool xorriso
xotcl - Extended Object Tcl (XOTcl): Object orientation for Tcl - shared library
xotcl-dev - Extended Object Tcl (XOTcl): Object orientation for Tcl - development files
xotcl-doc - Extended Object Tcl (XOTcl): Object orientation for Tcl - manual
xotcl-shells - Extended Object Tcl (XOTcl): Object orientation for Tcl - shells
znc-tcl - advanced modular IRC bouncer (Tcl extension)
ztclocalagent - sample application demonstrating Zero Touch Configuration
