apt-cache search tee
beneath-a-steel-sky - classic 2D point and click science fiction adventure game
boinc-screensaver - screen saver auto-controlling volunteer computing
ddnet - Teeworlds modification with a unique cooperative gameplay
dhall - configuration language guaranteed to terminate
fonts-sil-lateef - OpenType Arabic font for Sindhi and other languages of South Asia
golang-github-jteeuwen-go-bindata-dev - embed data in a Go program - library package
imagetooth - library generating images of teeth for odontograms
libdist-inkt-role-test-kwalitee-perl - check a distribution's kwalitee at build time
libdist-zilla-plugin-test-kwalitee-perl - Dist::Zilla plugin providing a release-time Kwalitee test
libfile-tee-perl - Perl module to duplicate streams like the tee unix command
libghc-acid-state-dev - Haskell database library with ACID guarantees - GHC libraries
libghc-acid-state-doc - Haskell database library with ACID guarantees - documentation; documentation
libghc-acid-state-prof - Haskell database library with ACID guarantees - GHC profiling libraries; profiling libraries
libghc-dhall-dev - configuration language guaranteed to terminate
libghc-dhall-doc - configuration language guaranteed to terminate; documentation
libghc-dhall-prof - configuration language guaranteed to terminate; profiling libraries
libghc-snap-server-dev - iteratee-based, epoll-enabled web server for the Snap Framework
libghc-snap-server-doc - iteratee-based, epoll-enabled web server for the Snap Framework; documentation
libghc-snap-server-prof - iteratee-based, epoll-enabled web server for the Snap Framework; profiling lib
libio-tee-perl - module for multiplexing output to multiple output handles
libmodule-cpants-analyse-perl - Perl module to generate Kwalitee ratings for a distribution
libspreadsheet-writeexcel-perl - module to create Excel spreadsheets
libspreadsheet-writeexcel-simple-perl - module providing simple creation of single-sheet Excel documents
libteem-dev - Tools to process and visualize scientific data and images - development
libteem2 - Tools to process and visualize scientific data and images - runtime
libtest-kwalitee-perl - module to test the quality of a Perl module distribution
msi-keyboard - command line tool to change MSI steelseries keyboards color setup
multitee - send multiple inputs to multiple outputs
node-create-ecdh - browserifiable createECDH
node-lodash-packages - Lo-dash is a Node.js utility library (per method packages)
node-stable - stable array sort, as Array#sort() is not guaranteed to be stable
openorienteering-mapper - Orienteering map drawing application
python-agateexcel-doc - documentation for agate-excel
python3-agateexcel - support for Excel files in agate
python3-subprocess-tee - alternative to subprocess.run like tee (Python 3.x)
sbcl-doc - Documentation for Steel Bank Common Lisp
teem-apps - Tools to process and visualize scientific data and images - command line tools
teensy-loader-cli - load and run programs onto your Teensy micro controller
teeworlds - online multi-player platform 2D shooter
teeworlds-data - data for Teeworlds; an online multi-player platform 2D shooter
teeworlds-server - server for Teeworlds; an online multi-player platform 2D shooter
trackballs - OpenGL-based game of steering a marble through a labyrinth
wordpress-theme-twentynineteen - weblog manager - twentynineteen theme files
