apt-cache search ssh
ec2-instance-connect - Configures ssh daemon to accept EC2 Instance Connect ssh keys
erlang-ssh - Erlang/OTP implementation of SSH protocol
libssh-4 - tiny C SSH library (OpenSSL flavor)
libssh-dev - tiny C SSH library - Development files (OpenSSL flavor)
libssh-doc - tiny C SSH library - Documentation files
libssh-gcrypt-4 - tiny C SSH library (gcrypt flavor)
libssh-gcrypt-dev - tiny C SSH library - Development files (gcrypt flavor)
openssh-client - secure shell (SSH) client, for secure access to remote machines
openssh-server - secure shell (SSH) server, for secure access from remote machines
openssh-sftp-server - secure shell (SSH) sftp server module, for SFTP access from remote machines
paramiko-doc - Make ssh v2 connections with Python (Documentation)
python3-parallax - Execute commands and copy files over SSH
python3-paramiko - Make ssh v2 connections (Python 3)
ssh - secure shell client and server (metapackage)
ssh-import-id - securely retrieve an SSH public key and install it locally
agent-transfer - copy a secret key from GnuPG's gpg-agent to OpenSSH's ssh-agent
authprogs - SSH Command Authenticator
autossh - Automatically restart SSH sessions and tunnels
clusterssh - administer multiple ssh or rsh shells simultaneously
cockpit-bridge - Cockpit bridge server-side component
crosshurd - Install a Debian system
dropbear - lightweight SSH2 server and client - startup scripts
dropbear-bin - lightweight SSH2 server and client - command line tools
dropbear-initramfs - lightweight SSH2 server and client - initramfs integration
easyssh - Complete, efficient and easy-to-use SSH manager
endlessh - SSH tarpit that slowly sends an endless connection banner
fssync - File system synchronization tool (1-way, over SSH)
fusiondirectory-plugin-ssh - ssh plugin for FusionDirectory
fusiondirectory-plugin-ssh-schema - LDAP schema for FusionDirectory ssh plugin
gesftpserver - sftp server submodule for OpenSSH
gitolite3 - SSH-based gatekeeper for git repositories (version 3)
golang-github-calmh-randomart-dev - generates OpenSSH-style randomart (Go library)
golang-github-charmbracelet-keygen-dev - SSH key pair generator (Go library)
golang-github-charmbracelet-wish-dev - Make SSH apps, just like that! ?? (Go library)
golang-github-gliderlabs-ssh-dev - Easy SSH servers in Golang
golang-github-kevinburke-ssh-config-dev - Go parser for ssh_config files
golang-github-mikesmitty-edkey-dev - generates ED25519 private keys in the OpenSSH private key format (Go library)
golang-github-pkg-sftp-dev - SFTP support for the golang.org/x/crypto/ssh package
golang-github-xanzy-ssh-agent-dev - Go library for creating SSH agents
gosa-plugin-ssh - ssh plugin for GOsa?
gosa-plugin-ssh-schema - LDAP schema for GOsa? ssh plugin
gpsshogi - Shogi playing program based on OpenShogiLib
gpsshogi-data - data files for gpsshogi
gpsshogi-viewer - Shogi studying GUI based on OpenShogiLib
guile-ssh - guile bindings for libssh
hash-slinger - tools to generate special DNS records
keepass2-plugin-keepasshttp - KeePass2 plugin to expose password entries securely over HTTP
keychain - key manager for OpenSSH
kodi-vfs-sftp - SSH File Transfer Protocol for Kodi
ksshaskpass - interactively prompt users for a passphrase for ssh-add
kwalletcli - command line interface to the KDE Wallet
libconfig-model-openssh-perl - configuration editor for OpenSsh
libganymed-ssh2-java - pure Java implementation of the SSH-2 protocol
libguac-client-ssh0 - HTML5 web application for accessing remote desktops (SSH support)
libguile-ssh13 - guile bindings for libssh
libj2ssh-java - Java library for the SSH protocol
libj2ssh-java-doc - Java library for the SSH protocol - documentation and examples
libjenkins-trilead-ssh2-java - Trilead SSH2 implementation for Java (Jenkins variant)
libjsch-agent-proxy-java - Proxy to ssh-agent and Pageant in Java
libjsch-java - Java implementation of the SSH2 protocol
libjsch-java-doc - Java implementation of the SSH2 protocol - documentation
libnet-openssh-compat-perl - collection of compatibility modules for Net::OpenSSH
libnet-openssh-parallel-perl - run SSH jobs in parallel
libnet-openssh-perl - Perl SSH client package implemented on top of OpenSSH
libnet-ssh-authorizedkeysfile-perl - Read and modify ssh's authorized_keys files
libnet-ssh-perl - Perl extension for secure shell
libnet-ssh2-perl - Perl module for the SSH 2 protocol
libpam-ssh - Authenticate using SSH keys
libpam-ssh-agent-auth - PAM Authentication via forwarded ssh-agent
libqt6labssharedimage6 - Qt 6 Labs Shared Image library
librust-git2+ssh-dev - Bindings to libgit2 for interoperating with git repositories - feature "ssh"
librust-git2+ssh-key-from-memory-dev - Bindings to libgit2 for interoperating with git repositories - feature "ssh_key_from_memory"
librust-libgit2-sys+libssh2-sys-dev - Native bindings to the libgit2 library - feature "libssh2-sys" and 1 more
librust-libgit2-sys-dev - Native bindings to the libgit2 library - Rust source code
librust-libssh2-sys-dev - Native bindings to the libssh2 library - Rust source code
libssh2-1 - SSH2 client-side library
libssh2-1-dev - SSH2 client-side library (development headers)
libtrilead-putty-extension-java - PuTTY key support for Trilead SSH2 library
libtrilead-ssh2-java - Java SSH library
libwagon-ssh-java - Artifact transport abstraction used in Maven (SSH providers)
lsh-client - Secure Shell v2 (SSH2) protocol client
lsh-doc - Secure Shell v2 (SSH2) documentation
lsh-server - Secure Shell v2 (SSH2) protocol server
lsh-utils - Secure Shell v2 (SSH2) protocol utilities
lxqt-openssh-askpass - OpenSSH user/password GUI dialog for LXQt
lxqt-openssh-askpass-l10n - Language package for lxqt-openssh-askpass
marsshooter - ridiculous space shooter governed by the laws of gravity
marsshooter-data - ridiculous space shooter governed by the laws of gravity -- data
monkeysphere - leverage the OpenPGP web of trust for SSH and TLS authentication
mssh - tool to administrate multiple servers at once
mussh - MUltihost SSH Wrapper
network-manager-ssh - network management framework (SSH plugin core)
network-manager-ssh-gnome - network management framework (SSH plugin GNOME GUI)
node-sshpk - library for finding and using SSH public keys
openssh-client-ssh1 - secure shell (SSH) client for legacy SSH1 protocol
openssh-known-hosts - download, filter and merge known_hosts for OpenSSH
openssh-tests - OpenSSH regression tests
php-seclib - implementations of an arbitrary-precision integer arithmetic library
php-ssh2 - Bindings for the libssh2 library
php-ssh2-all-dev - Bindings for the libssh2 library
php8.1-ssh2 - Bindings for the libssh2 library
progress-linux-ssh-keys - Progress Linux - SSH Keys
proxytunnel - Help SSH and other protocols through HTTP(S) proxies
pssh - Parallel versions of SSH-based tools
puppet-module-puppetlabs-sshkeys-core - Puppet module for managing SSH authorized_keys, and ssh_known_hosts files
puppet-module-saz-ssh - Puppet module for Ssh configuration (client and server)
puppet-module-voxpupuli-ssh-keygen - generate ssh keys for any user using ssh-keygen
putty - Telnet/SSH client for X
putty-tools - command-line tools for SSH, SCP, and SFTP
python-asyncssh-doc - asyncio-based client and server implementation of SSHv2 protocol (doc)
python3-asyncssh - asyncio-based client and server implementation of SSHv2 protocol
python3-netmiko - multi-vendor library for SSH connections to network devices - Python 3.X
python3-proxmoxer - Python Wrapper for the Proxmox 2.x API (HTTP and SSH) (Python 3)
python3-psshlib - Parallel versions of SSH-based tools (library)
python3-spur - Run commands easily over SSH (Python3)
python3-sshpubkeys - SSH public key parser - Python 3
python3-sshtunnel - SSH tunnels to remote server
r-cran-askpass - safe password entry for GNU R, Git, and SSH
r-cran-credentials - GNU R tools for managing SSH and Git credentials
restricted-ssh-commands - Restrict SSH users to a predefined set of commands
ruby-airbrussh - Concise log formatter for Capistrano and SSHKit
ruby-net-ssh - Ruby implementation of the SSH protocol
ruby-net-ssh-gateway - Ruby library for tunneling connections to servers with ssh
ruby-net-ssh-krb - Kerberos support for ruby-net-ssh
ruby-net-ssh-multi - Ruby library for making multiple SSH connections to remote systems
ruby-sshkey - SSH private/public key generator in Ruby
ruby-sshkit - toolkit for running commands in a structured way on one or more servers
runoverssh - POSIX-compliant shell script for running shell commands and scripts over SSH
salt-ssh - remote manager to administer servers via Salt SSH
scanssh - get SSH server versions for an entire network
secpanel - graphical user interface for SSH and SCP
sidedoor - SSH connection daemon
sidedoor-sudo - SSH connection daemon - sudoers entry
simple-tpm-pk11 - simple library for using the TPM chip to secure SSH keys
ssh-agent-filter - filtering proxy for ssh-agent
ssh-askpass - under X, asks user for a passphrase for ssh-add
ssh-askpass-fullscreen - Under Gnome2, asks user for a passphrase for ssh-add
ssh-askpass-gnome - interactive X program to prompt users for a passphrase for ssh-add
ssh-audit - tool for ssh server auditing
ssh-contact - establish SSH connections to your IM contacts using Telepathy (metapackage)
ssh-contact-client - establish SSH connections to your IM contacts using Telepathy (client)
ssh-contact-service - establish SSH connections to your IM contacts using Telepathy (server)
ssh-cron - cron daemon allowing ssh keys with passphrases to be used
ssh-tools - collection of various tools using ssh
sshcommand - turn SSH into a thin client specifically for your command
sshesame - fake SSH server
sshfs - filesystem client based on SSH File Transfer Protocol
sshguard - Protects from brute force attacks against ssh
sshoot - manage multiple sshuttle VPN sessions
sshpass - Non-interactive ssh password authentication
sshuttle - Transparent proxy server for VPN over SSH
ssshtest - stupid simple (ba)sh testing
ssvnc - Enhanced TightVNC viewer with SSL/SSH tunnel helper
task-ssh-server - SSH server
tinysshd - Tiny SSH server - daemon
tmate-ssh-server - terminal multiplexer with instant terminal sharing -- server
vagrant-sshfs - vagrant plugin that adds synced folder support with sshfs
x2gobroker-ssh - X2Go Session Broker (SSH broker)
yubikey-agent - seamless ssh agent for YubiKeys
zsnapd-rcmd - Remote sshd command checker for ZFS Snapshot Daemon
zssh - interactive file transfers over ssh
opendrim-lmp-ssh - OpenDRIM SSH provider
