apt-cache search tar
binutils-aarch64-linux-gnu - GNU binary utilities, for aarch64-linux-gnu target
binutils-aarch64-linux-gnu-dbg - GNU binary utilities, for aarch64-linux-gnu target (debug symbols)
binutils-arm-linux-gnueabihf - GNU binary utilities, for arm-linux-gnueabihf target
binutils-arm-linux-gnueabihf-dbg - GNU binary utilities, for arm-linux-gnueabihf target (debug symbols)
binutils-i686-gnu - GNU binary utilities, for i686-gnu target
binutils-i686-gnu-dbg - GNU binary utilities, for i686-gnu target (debug symbols)
binutils-i686-kfreebsd-gnu - GNU binary utilities, for i686-kfreebsd-gnu target
binutils-i686-kfreebsd-gnu-dbg - GNU binary utilities, for i686-kfreebsd-gnu target (debug symbols)
binutils-i686-linux-gnu - GNU binary utilities, for i686-linux-gnu target
binutils-i686-linux-gnu-dbg - GNU binary utilities, for i686-linux-gnu target (debug symbols)
binutils-multiarch - Binary utilities that support multi-arch targets
binutils-multiarch-dbg - Binary utilities that support multi-arch targets (debug symbols)
binutils-multiarch-dev - GNU binary utilities that support multi-arch targets (BFD development files)
binutils-powerpc-linux-gnu - GNU binary utilities, for powerpc-linux-gnu target
binutils-powerpc-linux-gnu-dbg - GNU binary utilities, for powerpc-linux-gnu target (debug symbols)
binutils-powerpc64le-linux-gnu - GNU binary utilities, for powerpc64le-linux-gnu target
binutils-powerpc64le-linux-gnu-dbg - GNU binary utilities, for powerpc64le-linux-gnu target (debug symbols)
binutils-riscv64-linux-gnu - GNU binary utilities, for riscv64-linux-gnu target
binutils-s390x-linux-gnu - GNU binary utilities, for s390x-linux-gnu target
binutils-s390x-linux-gnu-dbg - GNU binary utilities, for s390x-linux-gnu target (debug symbols)
binutils-x86-64-kfreebsd-gnu - GNU binary utilities, for x86-64-kfreebsd-gnu target
binutils-x86-64-kfreebsd-gnu-dbg - GNU binary utilities, for x86-64-kfreebsd-gnu target (debug symbols)
binutils-x86-64-linux-gnu - GNU binary utilities, for x86-64-linux-gnu target
binutils-x86-64-linux-gnu-dbg - GNU binary utilities, for x86-64-linux-gnu target (debug symbols)
binutils-x86-64-linux-gnux32 - GNU binary utilities, for x86-64-linux-gnux32 target
binutils-x86-64-linux-gnux32-dbg - GNU binary utilities, for x86-64-linux-gnux32 target (debug symbols)
cloud-initramfs-rooturl - use a tarball or squashfs image in a url as the root filesystem
cryptsetup - disk encryption support - startup scripts
gnome-startup-applications - Startup Applications manager for GNOME
language-pack-crh - translation updates for language Tatar, Crimean
language-pack-crh-base - translations for language Tatar, Crimean
language-pack-gnome-crh - GNOME translation updates for language Tatar, Crimean
language-pack-gnome-crh-base - GNOME translations for language Tatar, Crimean
libreoffice-style-elementary - office productivity suite -- Elementary symbol style
libstartup-notification0 - library for program launch feedback (shared library)
libstartup-notification0-dev - library for program launch feedback (development headers)
libwant-perl - generalisation of wantarray
needrestart - check which daemons need to be restarted after library upgrades
pax - Portable Archive Interchange (cpio, pax, tar)
perl - Larry Wall's Practical Extraction and Report Language
python3-rtslib-fb - object API for managing the Linux LIO kernel target - Python 3.x
strongswan-starter - strongSwan daemon starter and configuration file parser
tar - GNU version of the tar archiving utility
tar-doc - documentation for the tar package
targetcli-fb - Command shell for managing the Linux LIO kernel target
usb-creator-common - create a startup disk using a CD or disc image (common files)
usb-creator-gtk - create a startup disk using a CD or disc image (for GNOME)
64tass - cross (turbo) assembler targeting the MOS 65xx series of micro processors
apertium-crh-tur - Apertium translation data for the Crimean Tatar-Turkish pair
apertium-kaz-tat - Apertium translation data for the Kazakh-Tatar pair
aranym - Atari Running on Any Machine
astro-datareduction - Data reduction pipelines for astronomy
astronomical-almanac - astronomical almanac - calculate planet and star positions
autossh - Automatically restart SSH sessions and tunnels
bastet - ncurses Tetris clone with a bastard algorithm
betaradio - Internet radio of Taiwan
binutils-alpha-linux-gnu - GNU binary utilities, for alpha-linux-gnu target
binutils-alpha-linux-gnu-dbg - GNU binary utilities, for alpha-linux-gnu target (debug symbols)
binutils-arm-linux-gnueabi - GNU binary utilities, for arm-linux-gnueabi target
binutils-arm-linux-gnueabi-dbg - GNU binary utilities, for arm-linux-gnueabi target (debug symbols)
binutils-avr - Binary utilities supporting Atmel's AVR targets
binutils-h8300-hms - GNU binary utilities, for h8300-hitachi-coff target
binutils-hppa-linux-gnu - GNU binary utilities, for hppa-linux-gnu target
binutils-hppa-linux-gnu-dbg - GNU binary utilities, for hppa-linux-gnu target (debug symbols)
binutils-hppa64-linux-gnu - GNU assembler, linker and binary utilities targeted for hppa64-linux
binutils-hppa64-linux-gnu-dbg - GNU binutils targeted for hppa64-linux (debug symbols)
binutils-ia64-linux-gnu - GNU binary utilities, for ia64-linux-gnu target
binutils-ia64-linux-gnu-dbg - GNU binary utilities, for ia64-linux-gnu target (debug symbols)
binutils-m68hc1x - GNU binary utilities for Motorola's 68HC11/12 targets
binutils-m68k-linux-gnu - GNU binary utilities, for m68k-linux-gnu target
binutils-m68k-linux-gnu-dbg - GNU binary utilities, for m68k-linux-gnu target (debug symbols)
binutils-mips-linux-gnu - GNU binary utilities, for mips-linux-gnu target
binutils-mips-linux-gnu-dbg - GNU binary utilities, for mips-linux-gnu target (debug symbols)
binutils-mips64-linux-gnuabi64 - GNU binary utilities, for mips64-linux-gnuabi64 target
binutils-mips64-linux-gnuabi64-dbg - GNU binary utilities, for mips64-linux-gnuabi64 target (debug symbols)
binutils-mips64-linux-gnuabin32 - GNU binary utilities, for mips64-linux-gnuabin32 target
binutils-mips64-linux-gnuabin32-dbg - GNU binary utilities, for mips64-linux-gnuabin32 target (debug symbols)
binutils-mips64el-linux-gnuabi64 - GNU binary utilities, for mips64el-linux-gnuabi64 target
binutils-mips64el-linux-gnuabi64-dbg - GNU binary utilities, for mips64el-linux-gnuabi64 target (debug symbols)
binutils-mips64el-linux-gnuabin32 - GNU binary utilities, for mips64el-linux-gnuabin32 target
binutils-mips64el-linux-gnuabin32-dbg - GNU binary utilities, for mips64el-linux-gnuabin32 target (debug symbols)
binutils-mipsel-linux-gnu - GNU binary utilities, for mipsel-linux-gnu target
binutils-mipsel-linux-gnu-dbg - GNU binary utilities, for mipsel-linux-gnu target (debug symbols)
binutils-mipsisa32r6-linux-gnu - GNU binary utilities, for mipsisa32r6-linux-gnu target
binutils-mipsisa32r6-linux-gnu-dbg - GNU binary utilities, for mipsisa32r6-linux-gnu target (debug symbols)
binutils-mipsisa32r6el-linux-gnu - GNU binary utilities, for mipsisa32r6el-linux-gnu target
binutils-mipsisa32r6el-linux-gnu-dbg - GNU binary utilities, for mipsisa32r6el-linux-gnu target (debug symbols)
binutils-mipsisa64r6-linux-gnuabi64 - GNU binary utilities, for mipsisa64r6-linux-gnuabi64 target
binutils-mipsisa64r6-linux-gnuabi64-dbg - GNU binary utilities, for mipsisa64r6-linux-gnuabi64 target (debug symbols)
binutils-mipsisa64r6-linux-gnuabin32 - GNU binary utilities, for mipsisa64r6-linux-gnuabin32 target
binutils-mipsisa64r6-linux-gnuabin32-dbg - GNU binary utilities, for mipsisa64r6-linux-gnuabin32 target (debug symbols)
binutils-mipsisa64r6el-linux-gnuabi64 - GNU binary utilities, for mipsisa64r6el-linux-gnuabi64 target
binutils-mipsisa64r6el-linux-gnuabi64-dbg - GNU binary utilities, for mipsisa64r6el-linux-gnuabi64 target (debug symbols)
binutils-mipsisa64r6el-linux-gnuabin32 - GNU binary utilities, for mipsisa64r6el-linux-gnuabin32 target
binutils-mipsisa64r6el-linux-gnuabin32-dbg - GNU binary utilities, for mipsisa64r6el-linux-gnuabin32 target (debug symbols)
binutils-msp430 - Binary utilities supporting TI's MSP430 targets
binutils-powerpc64-linux-gnu - GNU binary utilities, for powerpc64-linux-gnu target
binutils-powerpc64-linux-gnu-dbg - GNU binary utilities, for powerpc64-linux-gnu target (debug symbols)
binutils-riscv64-linux-gnu-dbg - GNU binary utilities, for riscv64-linux-gnu target (debug symbols)
binutils-sh4-linux-gnu - GNU binary utilities, for sh4-linux-gnu target
binutils-sh4-linux-gnu-dbg - GNU binary utilities, for sh4-linux-gnu target (debug symbols)
binutils-sparc64-linux-gnu - GNU binary utilities, for sparc64-linux-gnu target
binutils-sparc64-linux-gnu-dbg - GNU binary utilities, for sparc64-linux-gnu target (debug symbols)
binutils-z80 - GNU binary utilities for the z80-unknown-coff target
brewtarget - GUI beer brewing software
cciss-vol-status - HP SmartArray RAID Volume Status Checker
charactermanaj - avatar editor application
chase - Follow a symlink and print out its target file
claws-mail-libravatar - Display sender avatar from a libravatar server
cloud-initramfs-updateroot - extract a tarball over root filesystem before pivot
cnvkit - Copy number variant detection from targeted DNA sequencing
dds2tar - Tools for using DDS features of DAT drives with GNU tar
deltarpm - Tools to create and apply deltarpms
dhcpstarv - DHCP starvation utility
dpkg-source-gitarchive - dpkg source format for git repositories
dropbear - lightweight SSH2 server and client - startup scripts
elementary-icon-theme - Original set of vector icons for elementary OS
elementary-xfce-icon-theme - elementary icon theme modified for Xfce
elpa-emacs-dashboard - extensible emacs startup screen showing you what's most important
elpa-esup - Emacs StartUp Profiler
elpa-restart-emacs - restart emacs from within emacs
endlessh - SSH tarpit that slowly sends an endless connection banner
etktab - ASCII guitar tab editor
fai-quickstart - Fully Automatic Installation quickstart package
fbautostart - XDG compliant autostarting app for Fluxbox
fonts-atarismall - Very small 4 x 8 font
fonts-cantarell - sans serif font family designed for on-screen readability
fonts-joscelyn - authentic secretary hand font
g++-mingw-w64-i686 - GNU C++ compiler for MinGW-w64 targeting Win32
g++-mingw-w64-x86-64 - GNU C++ compiler for MinGW-w64 targeting Win64
gcc-mingw-w64-i686 - GNU C compiler for MinGW-w64 targeting Win32
gcc-mingw-w64-x86-64 - GNU C compiler for MinGW-w64 targeting Win64
gdb-bpf - Cross-debugger for the bpf target
gdb-mingw-w64-target - Cross-debugger server for Win32 and Win64 using MinGW-w64
gfortran-mingw-w64-i686 - GNU Fortran compiler for MinGW-w64 targeting Win32
gfortran-mingw-w64-x86-64 - GNU Fortran compiler for MinGW-w64 targeting Win64
gnat-mingw-w64-i686 - GNU Ada compiler for MinGW-w64 targeting Win32
gnat-mingw-w64-x86-64 - GNU Ada compiler for MinGW-w64 targeting Win64
gnurobbo - logic game ported from ATARI XE/XL
gnurobbo-data - logic game ported from ATARI XE/XL - data files
gobjc++-mingw-w64-i686 - GNU Objective-C++ compiler for MinGW-w64 targeting Win32
gobjc++-mingw-w64-x86-64 - GNU Objective-C++ compiler for MinGW-w64 targeting Win64
gobjc-mingw-w64-i686 - GNU Objective-C compiler for MinGW-w64 targeting Win32
gobjc-mingw-w64-x86-64 - GNU Objective-C compiler for MinGW-w64 targeting Win64
golang-github-adam-lavrik-go-imath-dev - elementary functions for integer arguments (library)
golang-github-ajstarks-svgo-dev - generating online histograms and plotting them with golang
golang-github-bmatcuk-doublestar-dev - support for double star matches in golang's path.Match and filepath.Glob
golang-github-cloudflare-tableflip-dev - Graceful process restarts in Go (library)
golang-github-coreos-gexpect-dev - library for starting and controlling subprocesses
golang-github-docker-notary-dev - library for running and interacting with trusted collections
golang-github-facebookgo-grace-dev - Graceful restart & zero downtime deploy for Go servers
golang-github-guptarohit-asciigraph-dev - Make lightweight ASCII line graph in CLI apps with no other dependencies
golang-github-inconshreveable-mousetrap-dev - Go library to detect starting from Windows Explorer
golang-github-ishidawataru-sctp-dev - SCTP library for the Go programming language
golang-github-jhoonb-archivex-dev - archives folders (recursively) and files to zip and tar formats
golang-github-petar-gollrb-dev - LLRB implementation of balanced binary search trees for Go
golang-github-protonmail-go-autostart-dev - Go library to run a command after login
golang-github-protonmail-go-crypto-dev - Go supplementary cryptography libraries
golang-github-stvp-tempredis-dev - Go package to start and stop temporary redis-server processes
golang-github-tarm-serial-dev - Go package for serial port communucation
golang-github-vbatts-tar-split-dev - tar archive assembly/disassembly (source)
golang-golang-x-crypto-dev - Supplementary Go cryptography libraries
golang-golang-x-image-dev - supplementary Go image libraries
golang-golang-x-net-dev - Supplementary Go networking libraries
golang-golang-x-text-dev - Supplementary Go text-related libraries
golang-golang-x-time-dev - Go supplementary time packages
golang-golang-x-tools - supplementary Go tools
golang-golang-x-tools-dev - supplementary Go tools (development files)
golang-starlark-dev - Interpreter for the Starlark configuration language
golang-strk.kbt-projects-go-libravatar-dev - Simple Go library for serving federated avatars
grub-theme-starfield - GRand Unified Bootloader, version 2 (starfield theme)
gtkguitune - Guitar and other instruments tuner
guitarix - Rock guitar amplifier for JACK
guitarix-common - Guitarix - Common files
guitarix-doc - Guitarix - Development documentation
guitarix-ladspa - Guitarix - ladspa plugins
guitarix-lv2 - Guitarix - LV2 plugins
gxw-glade - Guitarix - GTK+ library Glade support
hatari - Emulator for the Atari ST, STE, TT, and Falcon computers
haxe - multi-target universal programming language
indi-orion-ssg3 - INDI Driver for Orion StarShoot G3 and G4 cameras
indi-starbook - INDI driver for Vixen Starbook telescope controllers
indi-starbook-ten - INDI driver for Vixen Starbook Ten telescope controllers
indi-sx - INDI driver for Starlight Xpress CCD and Filter Wheel
internetarchive - commandline interface to archive.org
ion-doc - Interplanetary Overlay Network - examples and documentation
iptables-netflow-dkms - iptables target which generates netflows
istgt - iSCSI userspace target daemon for Unix-like operating systems
jython-stilts - Starlink Tables Infrastructure Library Tool Set (Jython package)
katarakt - simple PDF viewer with two layouts
kirigami-gallery - set of QtQuick components targeted for mobile use
kirigami2-dev - set of QtQuick components targeted for mobile use
knockpy - Python3 tool designed to enumerate subdomains on a target domain
kstars - desktop planetarium, observation planning and telescope control
kstars-data - data files for KStars desktop planetarium
kstars-data-extra-tycho2 - Tycho-2 star catalog for KStars
kstart - Kerberos kinit supporting AFS and ticket refreshing
langford-dkms - Kernel drivers for the Per Vices Noctar IQ demodulator board
langford-utils - Control programs for the Per Vices Noctar IQ demodulator board
libapp-daemon-perl - Perl module to start an Application as a Daemon
libarchive-any-create-perl - abstract API to create tar/tar.gz/zip archives
libarchive-tar-wrapper-perl - API wrapper around the 'tar' utility
libarchive-tools - FreeBSD implementations of 'tar' and 'cpio' and other archive tools
libblasr-dev - tools for aligning PacBio reads to target sequences (development files)
libblasr5.3.5 - tools for aligning PacBio reads to target sequences
libcpan-perl-releases-perl - module for mapping Perl releases on CPAN to the location of the tarballs
libdaemon-generic-perl - framework to provide start/stop/reload for a daemon
libdist-zilla-plugin-autometaresources-perl - Dist::Zilla plugin to ease filling "resources" metadata
libdrpm-dev - library for handling deltarpm packages - development files
libdrpm0 - library for handling deltarpm packages
libelementary-bin - EFL widget set - helper programs
libelementary-data - EFL widget set - data files
libelementary1 - EFL widget set
libequinox-http-jetty-starter-java - Eclipse Equinox Jetty HTTP Service Starter
libgeo-metar-perl - accessing Aviation Weather Information with Perl
libgetargs-long-perl - Perl module to parse long function arguments
libghc-bitarray-dev - Mutable and immutable bit arrays
libghc-bitarray-doc - Mutable and immutable bit arrays; documentation
libghc-bitarray-prof - Mutable and immutable bit arrays; profiling libraries
libghc-graphscc-dev - Tarjan's algorithm for computing the SCCs of a graph
libghc-graphscc-doc - Tarjan's algorithm for computing the SCCs of a graph; documentation
libghc-graphscc-prof - Tarjan's algorithm for computing the SCCs of a graph; profiling libraries
libghc-tar-conduit-dev - Conduit based tar extraction mechanism
libghc-tar-conduit-doc - Conduit based tar extraction mechanism; documentation
libghc-tar-conduit-prof - Conduit based tar extraction mechanism; profiling libraries
libghc-tar-dev - reading, writing and manipulating ".tar" archive files
libghc-tar-doc - reading, writing and manipulating ".tar" archive files; documentation
libghc-tar-prof - reading, writing and manipulating ".tar" archive files; profiling libraries
libgravatar-url-perl - Perl interface to make URLs for Gravatars from an email address
libgtk-sharp-beans-cil - Supplementary CLI bindings for GTK 2.14+
libgtk-sharp-beans2.0-cil-dev - Supplementary CLI bindings for GTK 2.14+ - development package
libgxw-dev - Guitarix - GTK+ library (development files)
libgxw0 - Guitarix - GTK+ library
libgxwmm-dev - Guitarix - GTK+ C++ widget library (development files)
libgxwmm0 - Guitarix - GTK+ C++ widget library
libisrt-java - common runtime library by intarsys
libisrt-java-doc - common runtime library by intarsys (documentation)
libjs-autosize - script to automatically adjust textarea height to fit text - NodeJS
libjs-jquery-textchange - detects text changes for input and textarea elements
libjs-jquery-textcomplete - implement auto-complete support for textareas (browserified)
libjs-jquery-ui-theme-start - Start theme for jQuery UI
libjs-knowl - JavaScript library for transclusion of supplementary information
libjs-textarea-caret - JS library to get the xy coords of a textarea or input's caret
libkf5gravatar-data - KDE PIM gravatar library - data files
libkf5gravatar-dev - KDE PIM gravatar library, devel files
libkf5gravatar5abi2 - KDE PIM gravatar library
libkf5kirigami2-5 - set of QtQuick components targeted for mobile use
libkf5kirigami2-doc - set of QtQuick components targeted for mobile use (documentation)
liblocale-currency-format-perl - Perl functions for formatting monetary values
libmodule-starter-pbp-perl - Perl module to create new perl modules following best practices
libmodule-starter-perl - simple starter kit for Perl modules
libmodule-starter-plugin-cgiapp-perl - template based module starter for CGI apps
libmodule-starter-plugin-simplestore-perl - template storage methods for Module::Starter
libmodule-starter-plugin-tt2-perl - module providing Template toolkit support for Module::Starter
libmodule-starter-smart-perl - Module::Starter plugin to add new modules into existing distributions
libmoosex-multiinitarg-perl - Perl library providing attributes with aliases for constructors
libmr-tarantool-perl - perl driver for tarantool
libnet-smtps-perl - SSL/STARTTLS support for Net::SMTP
libnetsds-util-perl - Service Delivery Suite framework - supplementary packages
libnexstar-dev - Celestron/SkyWatcher telescope control library development files
libnexstar0 - Celestron/SkyWatcher telescope control shared library
libproc-invokeeditor-perl - Perl extension for starting a text editor
libreoffice-systray - transitional package for removed LibreOffice "Quickstarter"
librsyntaxtextarea-java - Java library for syntax highlighting text component
librsyntaxtextarea-java-doc - Java library for syntax highlighting text component (documentation)
librunning-commentary-perl - Perl module to call system() with tracking messages
librust-cargo-platform-dev - Cargo's representation of a target platform - Rust source code
librust-enum-unitary-dev - Trait and macro for unitary enums - Rust source code
librust-futures-channel-dev - Channels for asynchronous communication using futures-rs - Rust source code
librust-futures-core-dev - Core traits and types in for the `futures` library - Rust source code
librust-futures-task-dev - Tools for working with tasks - Rust source code
librust-log-reroute-dev - Support to change logging target for the log crate - Rust source code
librust-starship-module-config-derive-dev - Cross-shell prompt for astronauts - Rust source code
librust-tar+default-dev - A TAR file reader and writer - feature "default" and 1 more
librust-tar-dev - A TAR file reader and writer - Rust source code
librust-target-lexicon-dev - Targeting utilities for compilers and related tools - Rust source code
librust-unicode-xid-dev - Determine whether characters have the XID_Start or XID_Continue properties according to Unicode Standard Annex #31 - Rust source code
librust-winapi-dev - Raw FFI bindings for all of Windows API - Rust source code
librust-winapi-i686-pc-windows-gnu-dev - Import libraries for the i686-pc-windows-gnu target - Rust source code
librust-winapi-x86-64-pc-windows-gnu-dev - Import libraries for the x86_64-pc-windows-gnu target - Rust source code
libsavitar-dev - 3MF file handling library (development files)
libsavitar0 - 3MF file handling library (shared library)
libserver-starter-perl - superdaemon for hot-deploying Perl server programs
libstarlink-ast-dev - Handle World Coordinate Systems in Astronomy (development package)
libstarlink-ast-doc - Handle World Coordinate Systems in Astronomy (documentation)
libstarlink-ast-err9 - Handle World Coordinate Systems in Astronomy (error reporting)
libstarlink-ast-grf3d9 - Handle World Coordinate Systems in Astronomy (dummy 3d routines)
libstarlink-ast9 - Handle World Coordinate Systems in Astronomy (main shared lib)
libstarlink-pal-dev - Positional Astronomy Library (development files)
libstarlink-pal-doc - Positional Astronomy Library (documentation)
libstarlink-pal0 - Positional Astronomy Library (shared library)
libstaroffice-0.0-0 - Import filter library to import all StarOffice documents
libstaroffice-dev - Import filter library to import all StarOffice documents -- development
libstaroffice-doc - Import filter library to import all StarOffice documents -- documentation
libstaroffice-tools - Import filter library to import all StarOffice documents -- tools
libstarpu-1.3-8 - Task scheduler for heterogeneous multicore machines
libstarpu-dev - Task scheduler for heterogeneous multicore machines - dev
libstarpufft-1.3-2 - Task scheduler for heterogeneous multicore machines
libstarpumpi-1.3-3 - Task scheduler for heterogeneous multicore machines
libstarpurm-1.3-2 - Task scheduler for heterogeneous multicore machines
libtar-dev - C library for manipulating tar archives (development files)
libtar0 - C library for manipulating tar archives
libtemplate-plugin-gravatar-perl - Template Toolkit plugin for generating Gravatar URLs
libtemplate-timer-perl - rudimentary profiling module for Template Toolkit
libtophide-ocaml-dev - hide values that start with '_' in OCaml toplevel
libtrilinos-moertel-13.2 - mortar methods package - runtime files
libtrilinos-moertel-dev - mortar methods package - development files
libunarr-dev - Decompression library for RAR, TAR, ZIP and 7z archives (devel)
libunarr1 - Decompression library for RAR, TAR, ZIP and 7z archives (runtime)
libwwwbrowser-perl - Platform independent means to start a WWW browser
libzed-ocaml - abstract engine for text edition in OCaml (runtime)
libzed-ocaml-dev - abstract engine for text edition in OCaml (development tools)
lxsession-edit - configure what application start up automatically in LXDE
lynkeos.app - GNUstep app for processing planetary astronomical images
mapsembler2 - bioinformatics targeted assembly software
maradns-zoneserver - complementary server process to TCP functions for MaraDNS
mbed-test-wrapper - utility to wrap the mbed test loader for use by yotta targets
metar - utility to download/decode METAR reports
mingw-w64 - Development environment targeting 32- and 64-bit Windows
mingw-w64-i686-dev - Development files for MinGW-w64 targeting Win32
mingw-w64-x86-64-dev - Development files for MinGW-w64 targeting Win64
minidlna - lightweight DLNA/UPnP-AV server targeted at embedded systems
mopidy-internetarchive - Mopidy extension for playing music from the Internet Archive
msp430mcu - Spec files, headers and linker scripts for TI's MSP430 targets
multimedia-guitar - Packages for playing with your (virtual) guitar gear
needrestart-session - check for processes need to be restarted in user sessions
node-autosize - script to automatically adjust textarea height to fit text - Javascript
node-babel7 - Babel command line
node-jquery-textcomplete - implement auto-complete support for textareas
node-libravatar - libravatar library for NodeJS
node-lodash-packages - Lo-dash is a Node.js utility library (per method packages)
node-resumer - through stream that starts paused and resumes on the next tick
node-starttls - upgrade a regular `net.Stream` connection to a secure `tls` connection
node-tar - read and write portable tar archives module for Node.js
node-tar-fs - Node.js module that provides filesystem-like access to tar files
node-tar-stream - streaming tar parser and generator - Node.js module
node-trim-newlines - Trim newlines from start and/or end of a string
notary - tool for running and interacting with trusted collections
ns2 - Discrete event simulator targeted at networking research
nutsqlite - Dietary nutrition analysis software
ofxstatement - tool to convert proprietary bank statement to OFX format
openocd - Open on-chip JTAG/SWD debug solution for embedded target devices
pcmanx-gtk2 - user-friendly telnet client mainly targets BBS users
php-composer-xdebug-handler - Restarts a process without Xdebug
pixelmed-webstart-apps - DICOM implementation containing Image Viewer and a ECG Viewer - jnlp
planetary-system-stacker - create a sharp image of a planetary system object (moon, sun, planets)
planets - Gravitation simulation of planetary bodies
primus-nvidia - NVIDIA Primus support using the proprietary NVIDIA driver
pristine-lfs - regenerate pristine tarballs from git-lfs
pristine-tar - regenerate pristine tarballs
proftpd-mod-tar - ProFTPD module mod_tar
python-django-extra-views-doc - Complementary class-based generic views for Django (Documentation)
python3-bitarray - Python3 module for efficient boolean array handling
python3-deltarpm - Python3 bindings for deltarpm
python3-django-extra-views - Complementary class-based generic views for Django (Python3 version)
python3-django-gravatar2 - Python3 library that provides essential Gravatar support
python3-ephem - Compute positions of the planets and stars with Python
python3-flask-gravatar - Extension for Flask to make usage of Gravatar service
python3-internetarchive - python interface to archive.org
python3-project-generator-definitions - collection of target/MCU definitions for progen
python3-pycifrw - CIF/STAR file support for Python
python3-pymetar - Python interface to METAR reports
python3-savitar - 3MF file handling library (Python bindings)
python3-stardicter - Conversion tools from various formats to StarDict
python3-starlette - ASGI library ideal for building high performance asyncio services
qml-module-org-kde-kirigami2 - set of QtQuick components targeted for mobile use
qprogram-starter - Qt program to start programs or commands
qstardict - International dictionary written using Qt
r-bioc-purecn - copy number calling and SNV classification using targeted short read sequencing
r-cran-epibasix - GNU R Elementary Epidemiological Functions
r-cran-palmerpenguins - GNU R Palmer Archipelago (Antarctica) penguin data
r-cran-stars - scalable, spatiotemporal tidy arrays for GNU R
r-cran-startupmsg - GNU R utilities for start-up messages
r-cran-suppdists - GNU R Supplementary Distributions
r-cran-wikidatar - GNU R API Client Library for 'Wikidata'
rakarrack - Simple and easy guitar effects processor for GNU/Linux
rerun - tool to launch commands and restart them on filesystem changes
restartd - Process checker and/or restarter
rna-star - ultrafast universal RNA-seq aligner
rnahybrid - Fast and effective prediction of microRNA/target duplexes
rtirq-init - startup script for realtime-preempt enabled kernels
ruby-gravtastic - Ruby wrapper for Gravatar URLs
ruby-jekyll-avatar - Jekyll plugin for rendering GitHub avatars
ruby-minitar - Provides POSIX tarchive management for Ruby
ruby-scarf - Ruby library for generating initial avatars and identicons
sd2epub - StarOffice to OpenDocument converter
sd2odf - StarOffice to OpenDocument converter
sdcv - StarDict Console Version
selinux-policy-default - Strict and Targeted variants of the SELinux policy
sim4db - batch spliced alignment of cDNA sequences to a target genome
songwrite - guitar tablature editor and player
stardata-common - Common framework to manage astronomy packages
stardict - International dictionary lookup program - stardict.png icons
stardict-common - International dictionary lookup program - data files
stardict-czech - Stardict package for Czech dictionary of foreign words
stardict-gtk - International dictionary lookup program - gtk
stardict-plugin - International dictionary lookup program - common plugins
stardict-plugin-cal - International dictionary lookup program - cal plugin
stardict-plugin-espeak - International dictionary lookup program - eSpeak TTS plugin
stardict-plugin-festival - International dictionary lookup program - Festival TTS plugin
stardict-plugin-fortune - International dictionary lookup program - fortune plugin
stardict-plugin-info - International dictionary lookup program - info plugin
stardict-plugin-spell - International dictionary lookup program - spell plugin
stardict-tools - dictionary conversion tools of stardict
stardict-xmlittre - French Littr? dictionary for stardict
starfighter - 2D scrolling shooter game
starfighter-data - 2D scrolling shooter game -- data files
starlet - simple, high-performance PSGI/Plack HTTP server
starlink-array-java - N-dimensional array manipulation and I/O in Java
starlink-array-java-doc - N-dimensional array manipulation and I/O in Java (javadoc)
starlink-cdf-java - CDF table support for Starjava
starlink-cdf-java-doc - CDF table support for Starjava (Javadoc)
starlink-connect-java - Abstract classes for persistent connections to remote services
starlink-connect-java-doc - Abstract classes for persistent connections (javadoc)
starlink-datanode-java - Classes for hierarchical browsing of data structures
starlink-datanode-java-doc - Classes for hierarchical browsing of data structures (documentation)
starlink-dpac-java - Java classes to process GAIA data
starlink-dpac-java-doc - Java classes to process GAIA data (Javadoc)
starlink-ecsv-java - Parser for the metadata and data of an ECSV file
starlink-ecsv-java-doc - Parser for the metadata and data of an ECSV file (documentation)
starlink-fits-java - Classes for general FITS handling
starlink-fits-java-doc - Classes for general FITS handling (javadoc)
starlink-pal-java - Starlink Positional Astronomy Library (Java version)
starlink-pal-java-doc - Starlink Positional Astronomy Library (Java version) - documentation
starlink-registry-java - Starlink IVOA registry access
starlink-registry-java-doc - Starlink IVOA registry access (API docs)
starlink-table-java - Starlink Tables Infrastructure Library
starlink-table-java-doc - Starlink Tables Infrastructure Library (documentation)
starlink-task-java - Java framework for invoking user-level tasks
starlink-task-java-doc - Java framework for invoking user-level tasks (javadoc)
starlink-tjoin-java - Join subclasses for Starjava table class
starlink-tjoin-java-doc - Join subclasses for Starjava table class (Javadoc)
starlink-topcat-java - Tool for OPerations on Catalogues And Tables (Java library)
starlink-topcat-java-doc - Tool for OPerations on Catalogues And Tables (JavaDoc)
starlink-ttools-java - Starlink Tables Infrastructure Library Tool Set (Java library)
starlink-ttools-java-doc - Starlink Tables Infrastructure Library Tool Set (Javadoc)
starlink-util-java - Miscellaneous utilities for the Starjava classes
starlink-util-java-doc - Miscellaneous utilities for the Starjava classes (documentation)
starlink-vo-java - Virtual Observatory access classes
starlink-vo-java-doc - Virtual Observatory access classes (javadoc)
starlink-votable-java - Classes for VOTable input and output
starlink-votable-java-doc - Classes for VOTable input and output (javadoc)
starman - high-performance preforking PSGI/Plack web server
starplot - 3-dimensional perspective star map viewer
starpu-examples - Task scheduler for heterogeneous multicore machines - exs
starpu-tools - Task scheduler for heterogeneous multicore machines - tools
starvoyager - 2D space arcade game, themed around 'Star Trek' - binary
starvoyager-data - 2D space arcade game, themed around 'Star Trek' - data files
stella - Atari 2600 Emulator for SDL & the X Window System
stilts - Starlink Tables Infrastructure Library Tool Set
stilts-doc - Starlink Tables Infrastructure Library Tool Set (documentation)
sword-comm-mhcc - Matthew Henry Concise Commentary for SWORD
syslog-ng-mod-stardate - Enhanced system logging daemon (stardate plugin)
tango-starter - TANGO distributed control system - starter server
tar-scripts - optional scripts for GNU version of the tar archiving utility
tar-split - tar archive assembly/disassembly
tarantool - In-memory database with a Lua application server
tarantool-common - Tarantool in-memory database - common files
tarantool-dev - Tarantool in-memory database - development headers
tardiff - Tarball comparison tool
tardy - post-processor for tar command
tarlz - archiver with multimember lzip compression
tart - versatile and feature-rich email signature generator
tesseract-ocr-tat - tesseract-ocr language files for Tatar
tgt - Linux SCSI target user-space daemon and tools
tgt-glusterfs - Linux SCSI target user-space daemon and tools - GlusterFS support
tgt-rbd - Linux SCSI target user-space daemon and tools - RBD support
tiatracker - music tracker for making Atari VCS 2600
tuxguitar - Multitrack guitar tablature editor and player (gp3 to gp5)
tuxguitar-alsa - tuxguitar plugin for sound playback using ALSA
tuxguitar-fluidsynth - tuxguitar plugin for sound playback using fluidsynth
tuxguitar-jack - tuxguitar plugin for sound playback using JACKD
tuxguitar-jsa - tuxguitar plugin for sound playback using Java Sound API
tuxguitar-oss - tuxguitar plugin for sound playback using OSS
tuxtype - Educational Typing Tutor Game Starring Tux
tuxtype-data - Data files for the Educational Typing Tutor Game Starring Tux
unclutter-startup - autostart infrastructure for unclutter and unclutter-xfixes
unity-scope-home - Home scope that aggregates results from multiple scopes
usb-creator-kde - create a startup disk using a CD or disc image (for KDE)
virtualjaguar - Cross-platform Atari Jaguar emulator
virtuoso-vsp-startpage - high-performance database - web interface files
wmanager - window-manager selection tool used at X startup
wys - daemon to start/stop PulseAudio loopbacks for phone call audio
x2gothinclient-displaymanager - login daemon starting x2goclient in displaymanager mode
xdo - small console-based utility to perform elementary actions on windows
xmlstarlet - command line XML toolkit
xorriso-dd-target - Device evaluator and disk image copier for GNU/Linux
xplanet - planetary body renderer
xstarfish - X wallpaper generator
xtables-addons-common - Extensions targets and matches for iptables [tools, libs]
xtables-addons-dkms - Extensions targets and matches for iptables
xtables-addons-source - Extensions targets and matches for iptables [modules sources]
atari800 - Atari 8-bit emulator for SDL
bumblebee-nvidia - NVIDIA Optimus support using the proprietary NVIDIA driver
frogatto - 2D platformer game starring a quixotic frog
frogatto-data - 2D platformer game starring a quixotic frog (data files)
game-data-packager-runtime - Launcher for proprietary games
gliese - stellar data set from the Third Catalogue of Nearby Stars
libstar-parser-perl - STAR compliant data file parser for Perl
libstarpu-contrib-1.3-8 - Task scheduler for heterogeneous multicore machines
libstarpu-contrib-dev - Task scheduler for heterogeneous multicore machines - dev
libstarpu-contribfft-1.3-2 - Task scheduler for heterogeneous multicore machines
libstarpu-contribmpi-1.3-3 - Task scheduler for heterogeneous multicore machines
libstarpu-contribrm-1.3-2 - Task scheduler for heterogeneous multicore machines
nsight-compute-target - NVIDIA Nsight Compute (target specific libraries)
nsight-systems-target - NVIDIA Nsight Systems (target specific libraries)
rhvoice-tatar - RHVoice speech synthesizer - Tatar voice
stardict-english-czech - Stardict package for English-Czech dictionary
stardict-german-czech - Stardict package for German-Czech dictionary
starpu-contrib-examples - Task scheduler for heterogeneous multicore machines - exs
starpu-contrib-tools - Task scheduler for heterogeneous multicore machines - tools
yale - stellar data set from the Yale Bright Star Catalog
linux-starfive-5.17-headers-5.17.0-1012 - Header files related to Linux kernel version 5.17.0
linux-starfive-5.19-headers-5.19.0-1016 - Header files related to Linux kernel version 5.19.0
linux-starfive-5.19-headers-5.19.0-1017 - Header files related to Linux kernel version 5.19.0
linux-starfive-5.19-headers-5.19.0-1018 - Header files related to Linux kernel version 5.19.0
linux-starfive-5.19-headers-5.19.0-1019 - Header files related to Linux kernel version 5.19.0
aspnetcore-targeting-pack-6.0 - Internal - targeting pack for Microsoft.AspNetCore.App 6.0
aspnetcore-targeting-pack-7.0 - Internal - targeting pack for Microsoft.AspNetCore.App 7.0
dotnet-apphost-pack-6.0 - Internal - targeting pack for Microsoft.NETCore.App 6.0
dotnet-apphost-pack-7.0 - Internal - targeting pack for Microsoft.NETCore.App 7.0
dotnet-targeting-pack-6.0 - Internal - targeting pack for Microsoft.NETCore.App 6.0
dotnet-targeting-pack-7.0 - Internal - targeting pack for Microsoft.NETCore.App 7.0
netstandard-targeting-pack-2.1 - Internal - targeting pack for NETStandard.Library 2.1
netstandard-targeting-pack-2.1-7.0 - Internal - targeting pack for NETStandard.Library 2.1
